чемпион: чемпион чемпионами чемпионы чемпионов чемпионом чемпиона Чемпионы 
финал: финала финалу финале Финал финал 
морган: Морганом Моргану 
спонсор: спонсорам 
периодически: периодически 
сыграть: Сыграл сыграли сыграла сыграв сыграло сыграют сыграет сыграл сыграны сыграть 
безнадёжный: безнадежных 
карьера: карьере карьеру 
который: которых которая котором которые которую которое которому которым которыми который которого 
качество: качество качестве качествах 
нефтегаз: нефтегаза нефтегаз 
настоящий: настоящий настоящим 
объективно: объективно 
беруться: беруться 
врач: врачу врач врача Врачам врачам Врачи врачей 
мокрый: мокрая 
тот: Те тому тех те теми Тех 
кардинал: кардинал 
сквозняк: сквозняка 
шалить: шалит 
настроить: настроен настроят 
вылечить: вылечить 
кошкин: кошкин 
биатлонист: Биатлонисты биатлонисты биатлонистах биатлонист 
каждый: каждого каждые каждая каждый каждым Каждую каждом Каждая Каждый 
вносить: вносит вносить вносят 
остальной: остальные остальных остальное 
глупый: глупейшие глупый 
вероятный: вероятных 
аморфность: аморфность 
правило: правилах Правило правило правил 
проспект: проспекта 
убивать: убивает 
долго: долго 
писать: пишут пишите писать писал пиши пишу писали 
тренер: тренерам тренером Тренер тренеры тренеров тренер тренерах тренерами тренера 
антисемитский: антисемитская 
контракт: контракт контракта контракту контракте 
выходить: выходит выходят выходить выходил Выходя 
ойлерз: Ойлерз 
обменивать: обменивать 
взять: взять взял возьмет взяв возьмут Взял 
теннис: Теннис теннис 
сообщение: сообщениях сообщении 
авангард: Авангардом Авангард Авангарду Авангарде авангарда Авангарда 
матч: Матчи Матч матч матче Матче матчу матчами матчи матча матчей Матча матчах матчам матчем 
этап: этап этапа этапе 
поединок: поединок поединки поединков 
стабильность: Стабильность стабильность стабильности 
беларусии: Беларусии 
борт: борта бортов 
яннис: Яннис Янниса 
вид: виды видах видов виде виду вида вид 
вакансия: вакансией Вакансия 
столица: столицы столицей Столицей 
контрольный: Контрольные 
лига: лигах лиги лиг Лига лига лиге Лигу Лиги 
беспросветный: беспросветном 
иэн: Иэн 
поделить: поделят поделенные 
глубоко: глубоко 
франция: Франция Франции 
тыква: тыква 
зарубежный: Зарубежные 
путин: Путиным Путин 
настораживать: настораживает 
ахахахаха: Ахахахаха 
мадрид: Мадридом Мадрид 
март: Марте марта марте 
белоусов: Белоусова 
доброта: доброте 
кардиналс: Кардиналс 
клуб: клубы клубов клуб клубе клубах клуба Клуб Клубы 
умопомешательство: умопомешательство 
любой: любом любую любые любая 
сверху: сверху 
фетисов: Фетисов 
приготовиться: приготовьтесь 
удивительный: удивительное 
справиться: справился справились справилась 
успешно: успешно 
купить: купили купить куплены 
приглашать: приглашали приглашают 
необходимый: Необходимые 
йоханнес: Йоханнес 
банальный: банальная 
важный: важна важная Важны важнейшем важный важную важных важны 
проскакивать: проскакивало проскакивают 
убеждать: убеждать 
рекорд: Рекорд рекорды рекордов рекорд 
бла: бла 
проезд: проезд 
манул: Манул 
провести: провести проведут провели проведет провел 
виннипег: Виннипег Виннипегу Виннипега Виннипегом 
поупом: Поупом 
сервис: сервисах сервис сервисы 
рига: Риге 
ледниковый: Ледниковый 
значит: значит Значит 
пятый: пятым пятый пятое Пятый 
серия: Серия серию Серии серии серия 
проследовать: Проследовать проследует 
принуждение: принуждение 
уровень: уровень уровня уровне уровню 
омский: Омскую Омская 
скромный: скромная 
уверенный: увереннее уверен 
оборона: оборона обороны обороне 
кошарныйсегодня: Кошарныйсегодня 
наметить: намечен 
камера: камеру 
локомотив: Локомотив Локомотива Локомотивом 
полный: Полного полного полную полных полные полная Полная полное полным полный 
думать: думает Думал Думаете думают думаю думаешь Думаю думал Думаешь думали 
недавний: недавнем 
гонка: гонкам Гонки гонки гонке гонках гонка 
молодой: молодые молоды молодых 
ришар: Ришара 
сергей: Сергея Сергею Сергей 
увидеть: увидеть увидим увидел 
уменьшить: уменьшил 
обладатель: обладателя обладатели 
год: года годов лет годы год годом годам году годами 
интересный: интересных интересная интересен интересные интересна Интересных интересный интересного 
соцсеть: соцсети соцсетях 
гент: Гент 
лафреньер: Лафреньер 
делать: делаете делает делал делают делаешь делать делаем 
аликин: Аликин Аликину 
солнечный: солнечные солнечную 
общий: общем общий общая общей 
результат: результат результаты Результаты Результат 
забить: Забили забило забили забьет забить забил 
пляж: пляжи 
ряд: ряда ряд 
около: Около около 
израиль: Израиле 
среднее: среднем 
другой: другими других другого другие другому Другие другое другая другим 
тема: Тема теме тема тему 
профессиональный: профессиональные Профессиональные профессионального 
спортивный: спортивным Спортивная Спортивного спортивные спортивный 
нефтянушку: нефтянушку 
парировать: парировал 
проведение: проведению проведение проведения проведении 
единственный: единственный 
брюквина: Брюквину Брюквина Брюквин 
бобби: Бобби 
парламент: парламент 
вероника: Вероника 
усилие: усилия 
ценник: ценнику 
выкачать: выкачать выкачает 
баня: бане 
пофигизм: пофигизм 
выпасть: выпало 
ходить: ходят ходил ходить 
иначе: иначе 
готовый: готовы готов 
зоркий: Зоркий 
козырный: Козырный 
сезон: сезонах сезоне сезон Сезон сезоном сезоны сезонов сезонами сезона 
кг: кг КГ 
набор: набор 
заниматься: заниматься занимаются занимается 
сорок: Сорока 
собственный: собственный 
направить: направило направлены направили направить 
убрать: убери убрать 
ныть: ныть 
соперник: соперниках соперники соперника Соперниками соперниками сопернику соперник соперников 
планировать: планирует Планирую планировали 
болельщик: болельщиками Болельщиков болельщику болельщик Болельщикам болельщиков Болельщики болельщикам болельщики 
набрать: набрал набрать набрали набравший наберет набрав 
витязь: Витязь Витязем 
стоять: стоят стоял 
тп: тп 
специально: специально 
проявить: проявлено проявил проявили 
атлетика: атлетика Атлетик атлетике 
свен: Свен 
депутат: Депутат депутат Депутату 
поделиться: Поделитесь поделиться Поделиться поделился 
бо: Бо 
кевин: Кевин 
ваш: ваш ваша вашем вашему 
ски: ски Ски 
решить: решить решат решила 
повторить: повторил повторившему повторить 
сложный: сложные сложный сложных сложнее 
человек: людьми человека человек люди Люди людей Людей 
хоккеист: хоккеистам хоккеисты хоккеистов хоккеиста хоккеист хоккеистом хоккеистами 
канада: Канада Канады Канадой Канаде Канаду 
даниил: Даниил 
комфер: Комфер 
джон: Джон 
гимнастика: Гимнастика 
япония: Япония Японии 
заключительный: заключительных заключительный заключительном 
бейсбол: Бейсбол 
диана: Диана 
неделя: неделе недели 
нынешний: Нынешний нынешнем 
стать: станет стать Став стали стала станут стал стало 
выбрать: выбрать выбрали выбран Выберите 
последнийвчера: последнийвчера 
соревнование: соревнованиях соревнований соревнованиям 
стадион: стадиона стадион стадионе 
голеностопа: голеностопа 
валерий: Валерий 
кубок: Кубка кубка кубок Кубке кубком Кубок кубке 
халл: Халл 
гиперактивностью: гиперактивностью 
сторона: Стороны стороны стороне сторону 
мягкий: мягкий 
просто: просто Просто 
народ: народа народов народ народами 
приём: приема приемом прием 
совершить: совершили совершил 
воробей: Воробей Воробья 
дворец: дворец дворцы дворца Дворец дворце 
первый: первому первыми первым Первая первой Первыми первом Первого первая первые первого Первые первый первых Первый первую 
специалист: специалистов 
расслабляться: расслабляться 
попытка: попытке попытку попытка Попыток 
выполнить: выполнят выполнили Выполнят 
четвертьфинал: четвертьфиналы четвертьфиналов Четвертьфиналы четвертьфинале четвертьфинала четвертьфинал 
вдоль: вдоль 
защитник: защитнику защитника защитников защитники Защитник защитником защитник 
определиться: определятся 
непросто: непросто 
посмотреть: посмотрим посмотрите Посмотрим Посмотрите посмотрел посмотреть 
философия: философия Философия 
дивизион: дивизиона 
журналист: Журналист журналистом журналистов журналисту 
страна: странах стран стране Страны Страну страна странами страны Страна 
трансляция: трансляции трансляций трансляция трансляцией Трансляции трансляцию Трансляция 
молчать: молчу молчат 
впечатлять: впечатляет впечатляют 
ставить: Ставить ставят Ставил ставлю ставит ставило ставить 
швейцария: Швейцария Швейцарии 
команда: командах Команда командами командам команде команды команда командой команд команду Команды 
среда: среду 
киз: Киз 
титул: титула титул 
стимулировать: стимулировать 
живой: жива 
поспорить: поспорят 
выдвинуть: выдвинул 
бенджамин: Бенджамин 
основное: основном 
тренировочный: тренировочную 
опасный: опасны опасна опасных 
польский: польским польская польской 
знать: знал знаешь Знаете знать знаем знает знаете знаю знают 
активный: активные активное 
тьма: тьме 
реал: Реалом Реала Реал 
использовать: использует использовать использовали 
галлям: Галлямов 
задача: задачу Задачу задачей задача Задача задачи 
приходить: приходит приходишь 
заскочить: заскочить 
грамотно: грамотно 
оцука: Оцука 
занять: Занявшая занять занял заняла занявшие 
перенасытить: перенасыщен 
точка: точки точке точка 
коньячок: коньячку 
бф: БФ 
маркетинг: маркетинга маркетинг 
ожидать: ожидать ожидает ожидал 
английский: английского 
последний: последнее последний последние ПОСЛЕДНИЕ последнего Последний последних последняя Последние последнюю 
выход: выходом Выход выходе выход выходу 
картёжник: картежник 
время: Время времена время времени 
составлять: составляет составлять 
развитие: развитии развитие развитию 
съёмка: съемка 
снимок: снимки 
шаг: шаг шагов 
открывать: открывать 
проморолик: проморолике 
телеканал: телеканала телеканале телеканалы телеканалах телеканалов телеканал 
слово: слов словах словам слову слово 
состав: составом составе составах составы состава состав 
чемпионат: Чемпионате чемпионате Чемпионатами Чемпионат чемпионат чемпионата чемпионату Чемпионата 
участник: участники участников Участники 
остановить: остановить 
золотой: золотые 
финалист: финалиста финалист финалистов Финалисты 
проход: проход 
глаз: глазу глаз глаза 
семёрка: семерке 
работать: работаю работать работает работаем 
готовиться: Готовимся готовиться 
фанат: Фанат Фанаты фанаты фанат фанатов 
закрытый: закрыта закрыт 
вася: Вася 
маргис: Маргис 
больница: больнице больницу 
фхр: ФХР 
тестирование: тестирования 
дело: дело деле Дело делу 
завершать: завершает 
националистический: националистические 
актрисавидимо: актрисавидимо 
коляда: Коляда 
таблица: таблицу Таблица таблице таблицы таблицей 
ягр: Ягр 
прийти: Пришла придти пришел 
португалец: португалец 
хороший: лучших лучшим лучшие лучшая Хорошую Лучший хорошего хорошие хорошем Лучшая хороший лучший хорош хорошая Лучших хороших хорошим лучшего Хороший лучшем 
макаров: Макарова 
мускул: мускулами 
позиция: позицию позиция 
вылечивать: вылечивают 
уг: уг 
панарин: Панариным Панарин 
товарищеский: Товарищеские товарищеские 
статус: Статус статус статусе Статусы 
олимпиада: Олимпиада Олимпиаде Олимпиадах Олимпиаду Олимпиады 
ерунда: ерунды 
ливерпуль: Ливерпуль Ливерпуля 
сватать: сватают сватали 
учиться: учиться учится учимся 
пользоваться: пользуясь 
слалом: слаломе слалом 
покой: покой 
арсенал: Арсенала Арсенал 
поскольку: поскольку 
необкатанная: необкатанная 
блок: блока 
тринадцатый: тринадцатый 
локоть: локти 
помпа: помпой 
вести: ведет вело Вести ведем вести вел ведут Вел 
уходить: уходят уходящая 
обостриться: обострилась 
швед: Шведы шведам шведами шведы шведов 
первенство: первенства первенство Первенство первенстве 
европа: Европы Европа 
миранчука: Миранчука 
зальцбург: Зальцбург 
иметь: имел иметь имею имеет Имею имея 
наш: наш наше Наше нашим нашему Наших нашу нашей нашем Наши нашего наших наши Наша 
кодолу: Кодолу 
календарный: календарном 
столкнуться: столкнулся 
яндекс: Яндексу Яндексе Яндекс 
поле: поля 
интрига: интриг 
пост: посту Посты посты постами 
орра: Орра 
завершиться: завершится 
получаться: получается получалось 
холменколлене: Холменколлене 
светлогорск: Светлогорск 
развивать: развивал 
роджерс: Роджерс 
антуан: Антуана 
политика: политика Политика 
уснуть: уснуть 
ультраправый: ультраправые 
хозяйственный: хозяйственного 
индивидуальный: индивидуальное индивидуальные индивидуальных 
допинг: допинг 
егор: Егор 
сильный: сильная сильным сильнейшая сильный сильнейший сильнее 
этика: этике этики 
согласный: Согласен согласен 
пневмония: Пневмонию пневмонию пневмония 
деньжата: деньжат 
регулярный: регулярного регулярном Регулярный регулярный 
раковина: раковина 
читать: Читайте читаешь ЧИТАТЬ 
новосибирск: Новосибирску Новосибирске Новосибирск 
карта: карт 
вериться: верится 
огонь: огне огонь 
голос: голосов 
гол: гола голах голе голов голу 
регулярно: регулярно 
снегопад: снегопада 
фаворит: фавориты фаворит фаворитом фаворитами 
рейнджерс: Рейнджерс 
внимание: вниманию внимания внимание 
полиция: полиция полиции 
неймаравчера: Неймаравчера 
способ: способ способы 
бред: бредом бред 
нищета: Нищета нищета нищеты нищету 
турнир: турнир турниров турниры турниру турнирах турнира турнире 
лёгкий: Легкая легки полегче 
половина: Половина половиной половины половина половине 
выкинуть: выкинул 
поздравлять: Поздравляем поздравляю 
подобрать: подобрали 
молодёжный: молодежные молодежных молодежная молодежный Молодежный 
матыгинвчера: Матыгинвчера 
ярославский: ярославский 
шайба: шайбы шайбой шайб шайба шайбе шайбами Шайба шайбу 
бендзьвчера: Бендзьвчера 
университет: университетах университет 
поэтому: Поэтому поэтому 
постоянный: постоянных 
билет: билетов билета билеты билетам 
яркий: яркий ярких 
амбиция: амбиции 
мочь: могли Можете могут могу можешь можем мог можете 
любительский: любительский Любительский 
бизнес: бизнес БИЗНЕС Бизнес 
постоянно: постоянно 
лопотать: лопотать 
евгений: Евгений Евгения 
актриса: актриса актрисы 
повторников: повторников 
проходить: проходит проходят проходили проходи 
паспорт: паспортах паспорта 
совершенство: совершенству 
ребёнок: ребенка детям дети детьми детей ребенок 
скелетон: Скелетон скелетон скелетоне 
фильм: фильм фильмов фильме 
николай: Николай 
денисов: Денисов 
серьёзный: серьезное серьезную серьезная 
керрана: Керрана 
болл: Болл 
ярд: Ярд 
вица: вице 
вовремя: вовремя 
достаться: досталось 
зарипов: Зарипову 
нидерланды: Нидерланды 
касса: кассах кассы кассу 
расти: растет расти рос 
бюджет: бюджета бюджет бюджетом 
прогноз: Прогнозов Прогнозы 
свой: своем своя своего свои свой своему свое своими своих Свои 
павел: Павел 
добыча: добычу 
критика: критики критика 
один: одному одним одни одном одна Одна одно Одни одну 
получить: получить получим получил получили получит получат получите получила 
тяга: тяга тяге 
гастроль: гастроль 
раздевалка: раздевалки раздевалке 
результативный: результативный результативными результативных 
российский: российский российскую российские Российский российского российской Российских российская российских Российские 
выдать: выдал выдаст 
субсидия: субсидии 
снайпер: снайпер снайперов снайперы 
лавка: лавке 
партнёр: партнерам Партнеры партнеров 
чёт: четом 
дакар: Дакар 
указать: указано указали указаны 
ранний: раньше Раньше 
ужасный: ужасном ужасное 
переехать: переехали переехала 
воспользоваться: воспользовался воспользоваться воспользуются 
кот: Кот кот 
некоторый: некоторым некоторыми Некоторым 
постсоветский: постсоветского 
существование: существовании существование 
медиафутбола: медиафутбола 
взглянуть: взглянуть 
смотреть: смотрю смотреть Смотрел Смотреть смотрите смотрим смотрел смотрят Смотришь см 
партия: партии 
именно: именно Именно 
жюльена: Жюльена 
говно: говном говно 
скорый: СКОРОМ скорое скорей скором поскорее 
неплохой: неплоха неплохое неплохих 
решение: Решение решениями решения решение 
оказаться: оказаться оказались 
суряев: Суряев 
иркутск: Иркутска Иркутску 
заседание: заседании 
россиянин: Россияне россиян россиянин россиянином россияне россиянина 
часто: часто 
заявить: заявил заявила заявлена 
медаль: медалей медаль 
заполняемость: заполняемость 
чёткий: Четкое Четкий 
хватать: хватает хватало 
финляндия: Финляндией Финляндию Финляндии Финляндия 
заявление: заявлением заявлениям заявление 
мы: нами Нам нам 
юня: ЮНЯ 
атака: атаки Атака атака атаке атаку 
элитный: элитное 
шарль: Шарль 
брат: братья брат 
фестиваль: Фестиваль 
слышать: слышали слышал 
каток: каток катке катков 
напомнить: напомнит Напомним 
ювентус: Ювентус Ювентусом 
пятница: пятница пятницу 
знакомство: знакомств 
четвертина: четвертину 
муир: Муир 
гвоздь: гвоздями гвоздей 
волнение: Волнение 
хотеться: Хотелось хочется хотелось 
лыжница: лыжница 
продать: продал проданных 
бежать: Беги бежать 
показаться: показалось 
комитет: комитеты комитета Комитет 
лихорадить: лихорадит 
переживать: переживал 
топ: Топ топ 
изнасилование: изнасиловании 
консульский: консульском 
помощь: помощь помощью 
гладить: гладишь 
таки: таки 
инвалид: инвалида 
анхель: Анхель 
ахо: Ахо 
рпл: РПЛ 
отношение: отношений отношении отношение 
запас: запасе запас 
скукота: скукота 
разобрать: Разберем 
поиграть: поиграть Поиграй 
лыжник: лыжники лыжниках 
сказать: сказать скажу сказала Сказал скажешь сказано скажет Скажу сказал сказали 
эль: эль 
дуэт: дуэт 
без: безо 
найта: Найта 
мой: моем мои моему Мои 
моуринью: Моуринью 
сорокин: сорокина СОРОКИН Сорокин Сорокина 
центр: центра центр центру 
член: Члены 
залечивать: залечивает 
вестись: ведется велись ведутся 
лёд: льда льду лед 
пугать: пугающий 
минута: минуте минут минуты минутам минуту 
поменять: поменяют поменять Поменяют 
овечкин: Овечкиным Овечкин Овечкиными 
психологический: психологическую психологическом 
победить: победить победила победит победив победили победил 
китайско: Китайско китайско 
красивый: красивый Красивая красивые красивая 
восстановиться: восстановился 
авито: Авито 
клубный: клубный клубного клубную клубная 
учить: учить учат 
офф: офф 
интересно: Интересно интересно 
габриелла: Габриелла 
недовольный: недоволен 
вывод: выводы вывод выводов 
ролик: ролике ролик ролики 
обманывать: обманывает Обманывать 
билл: Биллу Билл билла Билла 
пирс: Пирсу 
система: системе системам системы систему 
злиться: злиться злятся 
верить: верят верить Верим верим верю Верю 
милан: Милан 
показывать: показывать показывали показывает показывают 
шестой: Шестое шестая 
американец: американцам Американцы американец американцев 
встречаться: встречалась встречаться встречались встречаются 
выкладывать: выкладывать выкладывай выкладывает 
гоп: гоп 
блестеть: блестит 
вековой: вековые 
себастьян: Себастьян 
видеть: видел видеть видите 
подписывать: подписывать подписывал 
рияде: Рияде 
календарь: календарь Календарь календарей календаре 
беспокоиться: беспокоиться 
нынче: Нынче нынче 
максимально: максимально 
альпина: Альпин 
главный: Главные главные главными главный Главная главных Главный главная 
артистка: артистка артистки 
барс: Барсе Барса Барсом Барсу Барсы Барс 
летний: летний летние летнего 
период: период периоде периода 
надежда: Надежда надеждах надежду надеждой надежда 
обозначать: обозначает 
ритмический: ритмический 
обязательно: Обязательно обязательно 
новый: Новой нового новых новый новые новую Нового Новые новой Новая новая 
переплатить: переплатили 
патрег: Патрег 
колдуэлл: Колдуэлл 
десятилетие: десятилетия 
теренс: Теренс 
вяльбе: Вяльбе 
зацепиться: зацепиться зацепились 
тасс: ТАСС 
пустой: пустые пустая 
квартира: квартиру 
переговоры: Переговоры переговоры 
мхл: МХЛ 
кричать: кричат кричала кричать 
вирусный: вирусную 
ноябрь: ноября ноябре 
фишер: Фишера 
добрынинвчера: Добрынинвчера 
дико: дико 
внешне: внешне 
петер: Петер 
вопрос: вопросы вопрос вопросов вопросом 
славянин: Славянам 
голодный: голодны 
разница: разницы разнице разница 
обращать: обращать 
австрия: Австрии Австрия 
арена: Арены арену арена Арену арены Арене Арена арене 
воспитывать: воспитывать 
общаться: общаюсь 
прийтись: пришелся Пришлось пришлось 
бороться: боролась борюсь бороться боролся борются борется 
молчание: молчания 
предпринять: предприняли 
общество: общества 
рассказать: рассказал рассказала расскажи 
веха: вех 
принципиальный: принципиальные принципиальная 
терюшков: Терюшков 
юниор: Юниор юниоров 
роберт: Роберт 
йокич: Йокич 
поражение: поражений поражению поражения поражении поражениях поражение 
известный: известный известны Известная известен известная 
жёстко: жестко 
узел: узел 
альфа: Альфа 
понравиться: понравилось понравились понравилась 
улучшение: улучшения улучшению 
минус: минусов минусы 
азербайджан: Азербайджане 
омск: Омск Омске Омска 
условие: условиях условия 
серыйвчера: Серыйвчера 
прыгнуть: прыгнуло прыгнули 
кувшиновсегодня: Кувшиновсегодня 
выиграть: выиграешь выиграет выиграли выиграть выиграл выиграла выигравшая 
класс: класса классы классах 
житель: жителей жителями 
платинум: Платинум 
пойти: пойти пошло 
якоб: Якоб 
день: дня дни день Днем днем дне 
забыть: забыли Забыть Забыли забыл 
элверсвчера: Элверсвчера 
ключевой: ключевой 
грозный: Грозном грозное 
перестать: перестанет перестал перестать Перестань 
преображаться: преображаются 
пробежать: пробежать 
виндиш: Виндиш 
выступление: выступлениях выступление 
влетать: Влетай 
реально: реально Реально 
прекрасный: прекрасен прекрасный 
креативный: креативный 
хартикайнен: Хартикайнен 
убить: убил Убьем 
почитать: Почитайте почитаю 
завтра: завтра Завтра 
пора: Пора пор пора 
принимать: принимали принимать 
вылегжанин: Вылегжанин 
медиафутбол: Медиафутбол 
мяч: мяча мячом мяч 
сумма: суммы 
заезд: заезд заездах 
территория: территорию 
туз: туза 
второй: вторым вторых вторую Вторая втором вторая второго Вторую 
помешать: помешать 
конкретный: конкретный 
четвёртый: Четвертый четвертый четвертом четвертая четвертое 
схватить: схвачен 
бегать: Бегает бегали 
обсуждать: обсуждал обсуждают 
должный: должен должна должны 
прочий: прочую Прочие прочие 
проиграть: проиграет проиграла Проиграли проиграть проиграли проиграл 
способствовать: способствует способствовать 
айлин: Айлин 
турнирный: турнирное турнирной 
лестер: Лестером Лестер 
поставить: поставить поставили поставь поставлю поставил 
большой: большому Большое побольше большое большом 
нормальный: нормальным нормальных 
перейти: перешла перешел 
устать: устали 
палец: пальцы 
итог: итоге Итоги итогам итоги 
лыжа: лыжам лыжах 
среди: Среди среди 
роналду: Роналду роналду 
несколько: Несколько нескольким несколько нескольких 
дмитрий: Дмитрий Дмитрием 
состояться: состоятся состоявшемся состоится 
ибо: ибо 
цена: цена Цене 
футбол: Футбол футбола футболу футболе футбол 
даллас: Далласа Даллас 
ждать: ждет Ждем ждать ждал ждут ждем 
фонограмма: фонограмму 
понсилуома: Понсилуома 
ответить: ответил ответим Ответить отвечу 
ссылка: ссылке ссылкой 
усик: Усик 
колено: колен 
добрый: добрые Добрый 
отлично: Отлично отлично 
польша: Польше Польша 
отрицательный: отрицательного 
бобслей: Бобслей 
послематчевыми: послематчевыми 
тоскливый: тоскливо 
энфилде: Энфилде 
кровоизлияние: кровоизлиянии 
нелепый: нелепая нелепые 
бетербиев: Бетербиев 
призвать: призвав призвал 
логотип: Логотип логотип 
чат: Чат 
коламбус: Коламбус 
мишин: Мишин 
флорида: Флоридой Флорида Флориде Флориды 
вратарь: Вратари вратарь вратарю вратаря вратаре вратарей вратарем вратарям Вратарь 
спросить: спросить спросите 
пачка: пачками 
оскорблять: оскорбляют 
владелец: Владелец 
группа: группам Группа группы Группы группе групп группа 
валентин: валентин Валентин 
наталья: Наталья 
вмещать: вмещает 
связка: связкой связок 
дебора: Дебора 
талант: таланту 
впервые: Впервые впервые 
вероятность: вероятность 
лишиться: лишиться лишились лишился 
нефть: Нефть нефти нефть 
феерить: феерить 
зомбоящик: зомбоящик 
пекин: Пекине Пекин Пекина 
рейтинг: рейтинга Рейтинг рейтинге рейтинги рейтинг рейтингов 
нольте: Нольте 
подписать: подписал подписали подпишет подписало 
пэн: Пэн 
архив: Архив 
скандал: скандале скандал 
конкуренция: конкуренция конкуренции 
сила: силами Сила силы сил 
вино: вино 
комбинационный: комбинационный 
устроить: устроят устроили устроил устроена 
момент: моментов моменты момент момента моментами моментах 
даниэль: Даниэль 
трепач: трепач Трепач 
творение: Творение 
яромир: Яромир 
звать: звать 
обменять: обменяют обменян обменяли 
синдром: синдрома 
безобразие: безобразие 
полуфиналист: полуфиналистов полуфиналистом 
апл: АПЛ 
кхл: КХЛ кхл 
русский: русские русским Русских русских русском 
фрибет: фрибет 
платный: платный 
словакия: Словакией Словакия Словакии 
лететь: летела летящая 
давненько: давненько 
хотеть: хочу хотел хочет хотела хотите хотят хотели Хочу 
наполоть: Наполи 
ресурс: ресурсы 
чтить: чтит чтят 
проблема: проблемах проблем Проблем проблеме проблему 
уроженец: уроженцы Уроженцы 
прежде: прежде Прежде 
индия: Индия 
усилить: усилить усилят 
разнообразие: разнообразия 
автомобилист: Автомобилист Автомобилисте Автомобилисту 
примерно: примерно 
германский: Германский Германского 
всероссийский: Всероссийских 
любовь: Любовь любви любовь 
казахстан: Казахстан Казахстаном Казахстана 
литр: литра 
себя: собой 
представлять: представляла представляем представляют представляешь Представляем 
ветеран: ветеранам ветеранов 
канал: каналах канал каналы канала каналам канале 
мимо: мимо 
шаманство: шаманством 
болеть: болели Болеет болеть болел болеет 
кучербаевнадеюсь: Кучербаевнадеюсь 
тест: тесты 
подъём: подъеме 
удовлетворение: удовлетворения 
достаточно: Достаточно достаточно 
дополнительный: дополнительным дополнительных 
сэ: СЭ 
китайский: китайскими китайская китайского китайскому китайских Китайский китайской 
комментарий: комментариям комментария комментариями комментариев комментарий Комментарий 
форма: Форма форму форме форма формы 
перегрузить: перегрузил перегрузили 
переусердствовать: переусердствовать 
передача: передачами передач передача передачу передачи 
доля: долю долей 
крендель: крендель 
возить: возили возят 
фора: фору 
автобус: Автобус автобусом автобус 
пивко: пивка 
смочь: сможет Сможете смогли смогут сможешь смогла сможем 
осложнить: осложнил 
неблагоприятный: неблагоприятную 
энергетика: энергетику 
руководство: руководству руководство 
нести: несете 
появиться: Появились появился появится появятся появилось 
молния: Молнии 
повышать: повышает 
смерть: смерти смерть 
чопорный: чопорный 
пс: ПС 
показать: показала покажут показали показать показал покажет 
собачий: собачья 
ночь: ночи 
история: история историю 
адаптироваться: адаптироваться 
лёгочный: легочную 
национальный: национальной национальный Национальной 
вариант: варианты вариантов вариант 
кожева: Кожева 
патрик: Патрик Патрика 
класть: класть 
перехват: перехватов перехват 
нисколько: нисколько 
давать: дают давало давать давали дает Давайте 
затычка: затычка 
бесполезный: бесполезен 
простой: Проста простое простая попроще Простых 
такой: такую таком таких Такие такие такая такое такого такими таким 
умный: умный 
ла: Ла ЛА 
любитель: Любители любителей 
нева: Неву Нева 
лыжный: лыжные лыжных Лыжные 
дезинформация: дезинформация 
разин: Разин 
помнить: помню 
сбережение: сбережения 
место: месте место мест места 
групповой: группового групповом 
середина: середины 
установить: установил установлен установить 
валерьевичвчера: Валерьевичвчера 
пробивать: пробивал 
риск: Риск риск 
бетон: бетоном 
агрессия: агрессия 
извинение: извинений извинения 
поражаться: поражаюсь 
мысль: мысль мыслями мыслей 
публика: публика публику 
отечество: Отечества 
зритель: зрителя зрителей Зрителей Зрителям 
недодача: недодача 
биатлон: биатлона Биатлон биатлоне биатлону 
сообщить: сообщив сообщил 
обычно: обычно Обычно 
двор: двору двор 
составить: составила составлен составят 
премия: премий 
ужас: ужасе ужас 
зарубинвчера: Зарубинвчера 
тарасов: Тарасова 
плюс: плюсом плюсы 
закрыться: закрылся 
государственный: Государственного Государственном 
белоруссия: Белоруссией Белоруссия 
джонатан: Джонатан Джонатана 
поток: потока 
забросить: забросил забросивший 
могущественный: могущественному 
разыгрывать: разыгрывающий разыгрывать 
отреагировать: отреагировал 
мат: мат 
обыгрывать: обыгрывал 
следить: Следите следят следить следил 
каша: каши 
крупный: крупную крупном крупные крупного 
лидер: Лидер лидера лидеров лидер лидером лидеры 
обижаться: обижайся 
выйти: вышли Вышел выйти вышедшие выйдут вышел вышла 
торино: Торино 
игра: игру игрой Игру играми Игр игр игре играх Игра Игры игра игры 
тишина: Тишина тишине 
шнурок: шнурки 
вылезти: вылезли вылезти 
непряеву: Непряеву 
фанк: фанка 
догнать: догнал 
тесса: Тесса 
программа: программе программой программу программы программа 
служба: служба 
назвать: назвали названных назвать назовите назвал 
реалистичный: реалистичный 
критик: критиков 
буднично: буднично 
обратный: обратное обратном 
сложиться: сложилось сложился сложится 
норвежец: норвежцев Норвежцы 
вчера: вчера Вчера 
условный: условный 
отразить: отразил отразив отразивший 
возвращаться: возвращаемся возвращается 
принести: принесли 
куча: кучу Куч 
куньлунь: Куньлуня Куньлунем 
запрет: запретов 
лаудрупом: Лаудрупом 
ка: КА 
стартовать: стартует стартовал 
эффективный: эффективнее эффективный 
омич: Омичей 
новосибирец: новосибирец 
продаваться: продавался продается 
критически: критически 
углубление: углублению углублении 
вес: весе весов 
предаторс: Предаторс 
вместо: Вместо вместо 
прошлый: прошлый прошлой прошлом Прошлый 
удача: Удачи удачи 
применить: применил 
ретроматчу: ретроматчу 
положительный: положительный положительные 
сайт: сайтах сайт сайте сайта сайтов 
полосатый: полосатые 
сирота: сиротам 
питер: Питеру Питере Питера Питер 
событие: событиями событиях событий 
оставаться: остается оставаясь 
фк: ФК 
евсеев: Евсеев 
что: чему 
бывало: бывало 
жалко: жалко 
командный: командный командные командная 
сталкиваться: сталкиваться 
квалифицироваться: квалифицировался квалифицировалась Квалифицировался 
виктория: Виктория 
дружно: дружно 
сторонник: сторонник 
восторг: восторг 
набивать: набивает 
кататься: катаются катался 
германия: Германия Германией Германии 
тарас: Тараса тараса 
знаменитый: знаменитого знаменитый 
слушать: слушай слушать 
нелепость: нелепость 
чемпионский: чемпионская Чемпионские 
мариона: Марион 
универсальность: универсальность 
юлаева: Юлаева 
клипперс: Клипперс 
противостояние: противостояние противостояния противостоянием 
предлагать: Предлагаем предлагали 
макеев: Макеев 
форсировать: форсировать 
якушев: Якушев 
еврей: еврей евреев 
томаш: Томаш 
бытовой: бытовом 
оправдать: оправдать 
женщина: Женщины женщины женщинами женщин 
говорить: говорю говори говорил говорит говорить говорят говоря 
дойти: дойдет дойти 
антирекорд: антирекорд 
хабиб: Хабиб 
тело: тела тело 
фристайл: фристайл фристайле фристайлу Фристайл 
молодёжь: молодежь молодежи 
навстречу: навстречу 
уход: уход уходе 
довольно: Довольно довольно 
мешать: мешайте мешает мешало 
брайан: Брайана Брайан 
считать: считает считают считать считал Считаю 
позапрошлый: позапрошлом 
зенит: Зенита Зенит 
решаться: решается решаются решалось 
справедливость: справедливости 
адам: Адам 
быть: Будьте будь будем будете будут Будем буду 
топот: Топот 
восемь: восемь 
менее: менее 
ин: ИН 
васильев: Васильева Васильев 
шиффрин: Шиффрин 
тесс: Тесс 
обойтись: обошлось обойтись 
иран: Иран 
сведение: сведение сведениям 
блистать: блистали блистал блещет 
возможный: возможный возможные возможное 
очередной: Очередное очередным очередная 
брэйди: Брэйди 
осознавать: осознавать 
вдесятером: вдесятером 
фридрих: Фридрих 
раскупить: раскупят раскупили 
рыдать: рыдал 
тренировать: тренировать 
касатонов: Касатонов 
присылать: присылайте 
ледовый: Ледовые ледовом Ледовом Ледовый 
шорты: Шорт шорт 
варшава: Варшаву 
баринвчера: баринвчера 
лежать: лежал 
концентрироваться: концентрируется 
санкт: Санкт 
детский: детский детском 
разыграться: разыгрался 
крол: Крол 
героиня: героиней 
вызов: вызов 
ый: ый 
категорично: категорично 
армения: Армении 
наоборот: наоборот НАОБОРОТ 
подписание: Подписание 
гранд: грандом 
судья: судье Судьи судей 
перелом: перелома перелом 
бурдасова: Бурдасова 
голкипер: голкиперу Голкипер голкипером голкиперов голкипер 
баскетбол: Баскетбол 
почему: Почему почему 
оценить: Оцените оценить оценил 
бадминтон: Бадминтон 
рейн: Рейну 
счёт: Счет счете счету счет счетом 
тш: ТШ 
воспитание: воспитании 
спорт: спорте Спорт спорту спорта спорт 
улица: улицы улице 
соблюдать: соблюдают соблюдать соблюдайте 
терять: теряет терять теряют 
парнишка: парнишку 
королева: Королева 
сегодняшний: сегодняшнее сегодняшний сегодняшние 
традиционный: традиционной традиционные 
итп: итп 
называть: называли называют 
обладать: обладает обладаем 
посол: посла 
остаться: оставшихся остался остаться останется 
бросать: бросают бросать бросал 
качественный: качественный качественная 
ощущение: ощущение ощущениям 
балашиха: Балашихи 
навык: навыки 
джо: Джо 
преуспеть: преуспел 
классический: классическим классический 
спасать: спасают 
хаас: Хаас 
отправить: Отправить отправить отправлен 
сплошной: сплошная 
невольно: Невольно 
гуманитарный: гуманитарного гуманитарных гуманитарному 
предстоять: предстоит 
орлов: Орлова Орлов 
продемонстрировать: продемонстрировали 
медикамент: медикаментов 
сильно: сильно 
осознать: осознаете 
победа: победами победа победу побед победе победы победой победам Победы Победа 
какой: какие Какую каких каким какую какое какого Какие 
залечить: залечил 
попасть: попасть попадут попадет попал 
продлевать: продлевать 
крайне: крайне 
занедорого: занедорого 
андрей: Андрея Андрей 
игрок: игроках игроков Игроки игрок игроком игрока игроки ИГРОК игрокам 
олимпийский: олимпийская олимпийскими Олимпийского Олимпийские олимпийских олимпийские олимпийское олимпийский олимпийском Олимпийскую Олимпийских олимпийского Олимпийский 
выращивать: выращивать 
костомаров: Костомаров 
ресторан: рестораны ресторана ресторане 
выпить: выпить 
клопп: Клопп 
ареал: ареала 
бесплатный: Бесплатных 
рост: рост ростом 
свободный: свободные свободным Свободные свободных 
байкал: Байкал Байкала 
покупка: покупке 
замена: замена 
петербург: Петербурге Петербург 
пара: пара Пары пары пару 
списать: списали спишешь 
мэттьюс: Мэттьюс 
быстров: Быстров 
мелкий: мелких мелкие 
двс: двс 
услышать: услышал Услышал 
стоить: стой 
бритвавчера: Бритвавчера 
отделение: отделении 
марафон: марафона 
вывести: вывел вывела 
пропаганда: пропаганда 
отчитаться: отчитался 
сектор: сектор секторе 
превосходно: превосходно 
делаться: делается 
кончиться: кончились 
понимать: понимаем понимаю Понимали понимать понимают понимает понимаете 
развиваться: развивается 
вперёд: вперед 
равный: равное равного равных 
клиника: клиниках клиники 
давление: давление 
кроме: кроме Кроме 
сделать: сделано Сделаем сделать сделала сделали сделал сделаем 
присутствие: присутствием 
выпустить: выпустят 
золото: золото золота золотом 
спад: спад спада спаде 
доллар: доллар 
сплошь: сплошь 
далёкий: Дальше дальше далеком 
недоступный: недоступны 
заметить: заметил 
цвет: цвета 
прошлое: прошлого 
ровный: ровном 
сомнение: сомнению сомнение 
отстать: отстань 
шанс: шанса шанс шансы шансах шансов 
весь: всем всеми всему Весь вся Всем весь 
йорк: Йорка Йорке Йорк 
яшкин: Яшкиным Яшкин 
воспоминание: воспоминаниями 
определить: определена определят определили определено 
итальянец: итальянцами итальянцы 
исключить: исключить исключены 
суббота: субботу суббота 
райан: Райан Райана 
найк: найк 
начать: начали начать начнут начнем 
посчитать: посчитайте посчитали 
жизнь: жизнь жизни 
унитарный: унитарная 
жена: жене жен 
драфт: драфта драфтами драфт драфте 
заезжать: заезжайте 
друг: друзья друг друга другу 
расстраиваться: расстраивайтесь 
комментатор: Комментатор комментаторов 
уважаемый: Уважаемый 
роттердам: Роттердаме 
стройка: стройку 
битком: битком 
финн: финнов финнами Финны финны 
мелькнуть: мелькнула 
действовать: действовать 
магнитогорск: Магнитогорск Магнитогорске 
футбольный: футбольные футбольный футбольном 
голосовать: голосовала голосуют 
илья: Илья 
совет: советом совета 
изменять: изменять 
голова: голове голову головы 
нужный: нужен Нужна нужное нужны нужна 
коламбусом: Коламбусом 
захотеть: захочет 
совершенствование: совершенствования 
мбаппе: Мбаппе 
ворота: воротах ворот ворота 
новость: новостях Новость новость новости новостей НОВОСТИ Новости 
джейсон: Джейсон 
поехать: поедет Поедут поеду 
список: список списке 
атмосфера: атмосфере 
равновесие: равновесие 
голиньковчера: Голиньковчера 
ранее: ранее Ранее 
ховард: Ховард 
орловвчера: Орловвчера 
идти: идем Иди идут идти идет 
варламов: Варламов 
хоккейный: хоккейные хоккейном хоккейная хоккейный Хоккейной Хоккейная хоккейной 
аргентина: Аргентина 
доказывать: доказывать доказывала 
предыдущий: предыдущий 
сероввчера: Сероввчера 
прислать: пришли 
признаваться: признаваясь 
понедельник: понедельник 
карлос: Карлос 
структура: структур 
пляжный: Пляжный 
нужно: нужно Нужно 
школа: школа школы школу 
первобытный: первобытное 
рейх: Рейхов Рейх Рейху Рейхом Рейха 
прямой: прямых Прямая прямом прямые прямая 
обилие: обилию 
засунуть: засунут 
придать: придаст 
расстояние: расстоянии 
порой: Порой 
ситуация: ситуация ситуаций ситуацию ситуацией Ситуация 
лечение: лечение 
кругозор: кругозора 
нерса: Нерса 
важно: Важно 
нич: Нич 
полностью: полностью 
третий: третьего третьем Третий Третья третий третьим 
пожелание: пожелания 
два: Две двумя двум две 
младший: младше 
гладбаху: Гладбаху 
завязать: завязал 
управление: управлению 
держаться: держаться держись держался 
президент: Президент президента президентом президент 
смотреться: смотрится смотрелся 
нож: ножа 
барбер: Барбер 
построить: построен 
кария: Кария 
рознь: рознь 
белорусский: белорусских белорусского Белорусская 
это: этим 
быстро: быстро 
федерация: Федерация Федерации федераций федерации 
чехия: Чехия Чехию Чехии Чехией 
хромать: хромают 
квартальнов: Квартальнов 
оценивать: оцениваете оценивать 
болезнь: болезней болезни болезнь 
пас: пасов 
образ: Образ образом 
секрет: секрет секрете секреты 
дождаться: дождаться дождутся 
музыкавчера: Музыкавчера 
словак: словаками 
встретиться: встретятся встретится 
ограничиться: ограничится 
лекарство: лекарство лекарства 
измениться: изменилась 
экстремальный: Экстремальные 
технически: технически 
примечание: ПРИМЕЧАНИЕ Примечание 
бывать: бывает 
отряд: Отряд 
мафон: мафоном 
агент: агентом 
западный: Западного Западному западных Западным Западных Западный 
гиньяр: Гиньяр 
заводчанинвчера: заводчанинвчера 
проверить: Проверьте 
руслан: Руслан 
мма: мма 
обычный: обычных обычный 
любить: любит любить люблю 
нечто: нечто 
вынести: вынесет вынес 
пропустить: пропущенных пропустил пропустили пропущенная пропустить 
хоронить: хороните хоронить 
детство: детстве детства 
ноль: нолем ноль 
гордиться: Горжусь 
плов: плове плов 
экватор: экватор 
отстоять: отстоять 
форвард: Форварда форварда форвард форварде Форварды Форвард 
военный: военная 
трибуна: Трибуны Трибуне трибуны трибуной трибунах 
приостановка: приостановке 
касаться: касается 
импакта: импакта 
обстановка: обстановка 
праворукий: праворукий 
скуратов: Скуратов 
василичвчера: Василичвчера 
отыграть: отыграть 
принять: приняли принято принял примут 
отказаться: отказались отказалась отказавшись 
заявка: заявку 
худобин: Худобин 
слишком: Слишком слишком 
вылетать: вылетают вылетает 
мейар: Мейар 
белов: Белов 
компания: компанию компания 
рома: Рома 
нехорошо: нехорошо 
кто: кого кем кому 
раз: раза 
казахский: казахский 
вертикаль: вертикаль 
взгляд: взглядами взгляд 
велоспорт: Велоспорт 
дрейф: дрейф 
сие: се 
зрение: зрения 
усман: Усман 
восток: востоке Востока Востоке 
достижение: достижение достижения 
розыгрыш: розыгрышем розыгрыш розыгрыше 
сбежать: сбегут 
вполне: Вполне вполне 
оправдываться: оправдываться 
совместить: совмещенная 
нету: нету Нету 
подкаст: Подкасты 
феттель: Феттель 
казахстанец: казахстанцем 
пройти: пройдут прошло пройти прошли прошла пройдет прошел 
эфир: эфир эфире 
шелемав: Шелемав 
йонна: Йонна 
абонемент: абонементы абонементов 
государство: государство 
норвежский: Норвежские норвежских 
расцвести: расцвел 
пердакам: пердакам 
насколько: Насколько 
шлюха: шлюхи 
профессор: Профессора ПРОФЕССОР 
кравцов: Кравцова 
глава: Глава главе 
обратить: обратит 
пётр: Петр 
сейчас: ща 
оборудование: оборудования 
квалификация: квалификация Квалификация квалификации 
застрять: застряла 
прохоркин: Прохоркин прохоркин 
модераторомнет: модераторомнет 
суд: суд суда 
выигрывать: выигрывала выигрывают выигрывали выигрывает 
отыгрываться: отыгрываться 
пропускать: пропускало Пропускал пропускать 
мечтать: мечтали 
баскетбольный: баскетбольный 
стремиться: стремимся стремятся стремиться 
горка: горкой 
бе: Бе 
прокат: прокаты 
сдержанность: сдержанность 
диплом: диплом дипломы 
опытный: опытный опытных Опытнейший 
ютуб: ютуб 
целенаправленно: Целенаправленно целенаправленно 
разговаривать: разговариваю разговаривали разговариваешь разговаривать 
целое: целом 
ошибка: ошибку ошибок 
понять: поняли понял понять 
правда: Правду 
массовый: Массовой 
жить: жить жил живут 
век: веке века 
заводить: заводит 
пересечься: пересечься 
никак: никак 
посвящать: посвящаю 
дубль: Дубль дублем дубль 
металлург: Металлурге металлургу Металлурга Металлургом Металлург 
написать: напишет написал написали 
фигурист: фигуристы фигуристов 
владимир: Владимир Владимира Владимиром 
есмантовичем: Есмантовичем 
тратить: тратить 
взрослый: взрослый 
отгрузка: отгрузке 
твой: твой твоим 
успеть: успеть 
стрельба: стрельбе Стрельба 
месяц: месяцев месяц месяцы месяца месяце 
истеричный: истеричные 
алёшин: Алешин 
сноуборд: сноуборд Сноуборд сноуборде 
белый: Белый 
сетка: сетки Сетка 
зыкова: Зыкова 
денвер: Денвер Денвере 
гражданство: гражданства гражданство 
правильно: правильно 
фигня: фигню 
газ: газ газом газа 
уралец: Уралец 
участвовать: участвую участвовать участвует участвуют 
пациент: пациенту пациентов 
союзничать: союзничать 
пересмотреть: Пересмотреть 
бонус: Бонусы бонусы бонусом бонусов 
час: час часа 
понятно: понятно Понятно 
уметь: умеешь умевший УМЕЕШЬ 
приводить: приводит 
нурмагомед: Нурмагомедов 
вымирать: вымирает 
статистика: статистики Статистика статистику статистике статистика 
возиться: возитесь 
дисциплина: дисциплины дисциплине дисциплина 
требовать: требовать требуем требуя 
учесть: учти учтены 
личность: личности 
рада: рады 
госсовет: Госсовета 
непогода: непогода 
ильявчера: Ильявчера 
телепартнер: телепартнер 
сравнивать: сравнивать 
де: Де де 
львиный: львиную 
предусмотреть: предусмотрены 
продолжаться: продолжаться продолжаются 
снайперюга: Снайперюга 
имин: Имин 
продажа: продаже продажу 
победитель: победителем Победители победитель победителя победителям победители победителей 
радость: радость радости 
дотянуться: дотянуться 
трижды: трижды 
творчески: творчески 
алексеевичвчера: Алексеевичвчера 
миллионный: миллионная 
уникальный: уникальное 
отзыв: отзывы 
сейв: сейв 
неудачный: неудачная неудачного 
открытие: открытия открытие 
распределять: распределяет 
кучербаевсегодня: Кучербаевсегодня 
случайный: случайный 
укладываться: укладывается 
иностранец: иностранцы иностранцев 
старт: старт старта стартом старте 
средний: средней средняя Средняя 
добраться: добрались добраться 
бить: бью Бей бьют 
репутация: репутацию 
издеваться: издевается 
сюда: сюда Сюда 
герт: Герту 
североамериканец: североамериканцах 
становиться: становится 
дистанция: дистанции 
ратибор: Ратибор 
склифосовский: Склифосовский 
пёстрый: пестрый 
сопротивление: сопротивление 
особо: особо 
зона: зону зоне зоны зона 
тяжёлый: Тяжелая тяжелом тяжелое тяжелых 
тульский: тульский Тульской Тульском 
некогда: некогда 
залетать: залетают 
играть: играть Играть играли Играй играл играла играют играю Играет игравший играет играющих 
нанести: нанес 
река: Река 
данный: данном 
терентьев: Терентьев 
сильвия: Сильвия 
мюнхенец: мюнхенцы 
погулять: погулять 
моревбыл: Моревбыл 
переход: переходы переходу переходе перехода 
ретроматчи: ретроматчи 
депай: Депай 
вновь: вновь 
петь: пели 
официальный: официальном официальный 
забывать: забывать 
бросок: бросков броска бросок 
сохранять: сохраняет 
достойно: достойно 
моки: моки 
катушка: катушку 
опровергнуть: опровергли опроверг 
конкурировать: конкурировать 
перевоз: Перевоз 
наблюдать: наблюдать 
хвичу: Хвичу 
распределить: распределила 
ридзик: Ридзик 
барселона: Барселоны Барселоне Барселона 
самый: самая самые самую самое Самое самых самый Самый 
втб: ВТБ 
доказать: доказано доказали 
справляться: справляется 
ян: Янам Ян 
лор: Лора 
хм: Хм 
грубый: грубые 
оказываться: оказывались Оказывается 
шантаж: шантаж 
шалунова: Шалунова 
следовать: следует 
створ: створ 
число: числу чисел число числе 
анастасия: Анастасия 
поместить: поместил 
стартовый: стартов 
экспертвчера: экспертвчера 
обещать: обещая 
казенкинскийсегодня: Казенкинскийсегодня 
разрывать: разрывает 
митякин: Митякин 
отставать: отстает 
рикошетом: рикошетом 
трофей: трофея трофей 
шреддоголовыйвчера: Шреддоголовыйвчера 
популярный: Популярные 
обойма: обойме 
узнать: узнать 
звезда: звезды звезд звездой звезда 
наиболее: наиболее 
оправдывать: оправдывает 
независимо: независимо 
шок: шок шока шоке 
джеймс: Джеймс 
гигантский: гигантском 
прекрасно: прекрасно 
четыре: четырьмя четыре четырех 
принцип: принципу принципе 
бакинвчера: Бакинвчера 
нежный: нежная 
медик: медиков 
поль: Поль 
пердаков: пердаков 
зарплата: зарплата зарплат 
запускать: запускать 
майкл: Майклом 
шум: шума 
дания: Дания Дании 
новосиб: Новосиб Новосибом 
целый: целой 
перспектива: перспектив 
спасти: спасти спас 
умнеть: умней 
удалить: удалили 
представить: представлено 
перенести: перенесены 
открыть: открыли открыть Открыл откроют 
обмен: обмен обмена обменов 
мокнуть: МОК 
шестаков: Шестаков 
семь: Семь семь семи 
комиссия: Комиссия комиссии комиссией комиссия 
побороться: поборется поборитесь побороться поборются 
достоинствавчера: Достоинствавчера 
казаться: казалось кажется 
увы: Увы увы 
рукав: рукавах рукаве 
данилавчера: Данилавчера 
стараться: стараться 
хоккей: Хоккей хоккее хоккеем хоккея хоккею хоккей 
норвегия: Норвегия Норвегии 
уступить: уступили уступил уступив уступила 
миннесота: Миннесота 
отметка: отметки 
даниса: Данису Данис 
валиуллин: Валиуллин 
прописывать: прописывали 
оцениваться: оценивается 
мужской: мужская мужских Мужские мужского 
танцевальный: танцевальный 
насчёт: насчет 
иванычсегодня: Иванычсегодня 
оба: обоим обе обеих 
аркан: арканы 
семиматчевую: семиматчевую 
перспективный: перспективный перспективной 
ржать: ржал 
юрий: Юрий 
невскийвчера: Невскийвчера 
шелемасегодня: Шелемасегодня 
занятость: занятости 
разгромный: Разгромное 
литовецвчера: литовецвчера 
физический: физической физический физические 
прошлогодний: прошлогодний 
позор: позор 
сборная: сборная сборную сборными Сборная сборной 
ученыйвчера: Ученыйвчера 
смысл: смысле смысла 
закалять: закаляют 
экспорт: экспорту 
отдать: отдали отдадут отдаст отдал 
платформа: платформе 
заказ: заказу 
алина: Алина 
барбара: Барбаре Барбары 
курт: Курт 
подарить: подарит 
получиться: получился получилось 
зеленоградск: Зеленоградск 
штурм: штурм 
угода: угоду 
свод: сводами 
вечер: вечер 
влияние: влияние 
отдыхать: отдыхать 
случиться: случилось 
признаться: признался 
комплект: комплекта комплектов 
горячий: горячий горячая 
показание: показания 
детройт: Детройтом 
вживую: вживую 
поездка: поездку поездка 
регент: регенту 
сменить: сменить 
нереально: нереально 
катиться: катился 
вад: Ваде 
тихий: тихий 
смена: смены 
основа: основу 
миллер: Миллер 
опередить: опередить опередили 
номер: номеров номер 
джинсы: джинсах 
приличный: приличная 
состоятельный: состоятельных 
отправиться: отправился отправятся 
выступить: выступили выступил выступит выступят выступить 
поработать: поработал Поработаем 
нижний: Нижнем 
расизм: расизме 
рубиться: рубиться 
обрасти: обрастут 
запланировать: запланировано 
сукин: сукин 
минимальный: минимальным 
полегоньку: полегоньку 
вспомнить: вспомнил Вспомни вспомним вспомню Вспомните вспомнить 
также: также Также 
браться: берутся 
отличный: отличное Отличные 
оскорбление: оскорбление 
унести: унесли 
бомбардир: бомбардира бомбардир 
ярко: ярко 
тренерский: тренерские тренерскими 
заслуженно: заслуженно 
разыскивать: разыскивать 
валенсия: Валенсия 
набоков: Набокова Набоков 
прилетать: прилетает 
магазин: магазин магазине 
эксперт: эксперты 
кавабунга: Кавабунга 
фактор: фактор 
желание: желании желания желание 
марат: Марат 
роль: ролью ролях роль 
энд: энд 
тарелка: тарелка 
распределение: распределения 
сын: сыном сын Сын 
представитель: представители представителям 
полуфинал: полуфинале полуфиналов полуфинал полуфиналы Полуфиналы 
офис: офиса 
способный: способен способны 
тип: типу типа 
международный: международных международной международном 
буш: Буше 
укрепление: укреплении 
маркет: Маркета 
услуга: услугами 
фраза: фраза фразу 
специальный: специальном 
эбола: эбола 
задать: задайте 
покка: Покка 
предел: предела пределы пределами 
разгром: разгрома 
обыграть: обыграли обыграл обыграть Обыграли обыграла 
бригада: бригаде 
эпизодический: эпизодические 
обучать: обучать 
раунд: раунды Раунд раунда раунду раунд раунде 
цыган: цыганом 
союз: союз Союза 
тимашеввчера: Тимашеввчера 
работа: работе работа работы 
обручиться: обручилась 
непредсказуемый: непредсказуемо 
кодола: Кодола 
перекрыть: перекроет 
оппонент: оппонент 
вытаскивать: вытаскивают вытаскивал 
досрочно: досрочно 
сморщковсегодня: Сморщковсегодня 
провал: провалы 
борьба: Борьба борьба борьбу борьбы 
удаление: удалениями удаления удалений 
балалайка: балалайке 
тьфу: Тьфу 
чувствовать: чувствуют чувствует чувствуешь чувствовать Чувствую 
эк: Эк 
эрик: Эрик 
корея: Корея 
соревновательный: соревновательный 
огромный: огромный огромного 
денис: Денис 
нейтралитет: нейтралитет 
рвать: рвала 
плохой: Хуже похуже худшая хуже плохие худший плохи плохая плох 
бесплатно: бесплатно 
головин: Головин Головина 
причина: Причина причина причине 
железняк: Железняков 
надеяться: Надеемся Надеюсь надеялся надеемся надеюсь надеяться 
таракан: тараканами 
подтвердить: подтвердил 
он: нему 
лоббирование: лоббирования 
своеобразный: своеобразный 
доминик: Доминик 
запад: Запада запада Западе 
награда: награды наград 
рафаэль: Рафаэль 
пол: Пола 
выгнать: выгнали 
правосудие: правосудие правосудия 
богатство: богатство 
станцевать: станцевали 
гон: гон 
поколение: поколения 
апрель: апреля 
красиво: красиво 
уэйн: Уэйну Уэйн 
сократить: сократили 
рутина: рутину 
клюшка: клюшкой Клюшка клюшку 
тейтума: Тейтума 
целиком: целиком 
одиночка: одиночку 
будущее: будущем будущее 
спутниковый: спутниковое 
этот: этих ету эта Эта этими 
знание: знания 
оставить: оставят оставили оставит оставил оставила 
продолжать: продолжало продолжает продолжать 
вслед: Вслед 
впечатление: впечатление 
носить: носит 
гамп: Гамп 
водочка: Водочка 
халиль: Халили 
жечь: жги 
забивать: забивает забивал забивать забиваешь забивают 
заруб: Заруба 
шуткинвчера: Шуткинвчера 
ларкин: Ларкин 
ничто: Ничто ничем Ничем 
создавать: создавать 
буллит: буллиты буллите буллитов буллитам буллит буллита 
заиграть: заиграет 
хайлайтов: хайлайтов 
выкупать: выкупал 
расписание: расписание расписанием Расписание 
реализация: реализации 
усталость: усталости 
подкорректировать: подкорректировать 
мурад: Мурад 
выкладка: выкладками 
дальний: Дальнем 
высоко: повыше 
разгар: разгар 
благотворительный: благотворительный 
рука: рук руки 
процент: процент процентом процентам 
каприз: Каприз Капризов КАПРИЗОВ 
незамысловатый: незамысловато 
субсидировать: субсидируемое 
фёдоров: Федорова Федоров 
режим: режиме 
ванкувер: ванкувер Ванкуверу Ванкувера 
возможно: возможно Возможно 
габаритный: габаритный 
возраст: возрасте возраст 
организм: организм Организм 
содружество: Содружества 
скоро: Скоро СКОРО скоро 
многие: Многие многие 
удаться: удалось 
стиль: стиль стилем стиле Стиль 
фракция: фракции 
трамплин: трамплина трамплине трамплин 
травма: травмой травму травм травмами травма травмы 
москва: Москве Москвы Москву Москва 
сюжет: сюжетов 
учитываться: учитываются 
взятка: взятку 
минимум: минимуму минимум 
признать: признан признать 
закрыть: Закрыть Закрыл закрыли 
телевещателя: телевещателя 
загадывать: загадывать 
график: график 
ограничить: ограничены 
платить: платили платят 
гагарин: Гагарина 
стратегический: стратегического стратегическая 
зависеть: зависит зависеть 
спрос: спрос 
сообщество: сообщества 
ничушкин: Ничушкин 
рубль: рублей 
маркус: Маркус 
существовать: существует 
точно: точно 
никто: никому Никто Никого никто 
уральский: уральская 
перерасти: перерос 
благодаря: благодаря 
коронавирус: коронавируса коронавирус 
отъезд: отъезд 
фуруно: Фуруно 
вверху: вверху 
просьба: просьбе 
гиннис: Гиннис 
возглавить: возглавит 
лавиолетт: Лавиолетт 
нота: ноту 
захватывающий: захватывающе 
деньга: деньги денег Деньги 
показ: показов показа 
собраться: собралась 
провинциальный: провинциальных 
ахмат: Ахмата 
немецкий: немецкий немецким немецкую 
обязать: обязана обязаны 
скрывать: скрывать 
франкфурт: Франкфурт 
зуб: зуб зубов зубы 
коньяк: коньяк 
речь: речь речах 
медленный: медленного 
октябрь: октября октябре октябрь 
звено: звене звенья звено 
комик: комика 
импонировать: импонирует 
сарказм: сарказм 
твиттер: твиттер 
купание: купанием 
придумать: придумают 
тула: Тула Тулы 
невероятно: Невероятно невероятно 
сихоукс: сихоукс 
площадка: площадки площадку площадке 
выглядеть: выглядела выглядеть выглядят выглядит Выглядит 
разрыв: разрыв 
стабилизировать: стабилизировать 
город: городов города городах городами городе город 
занятый: заняты 
пытаться: пытаются пытаешься пытаться пытается 
неправильный: неправильным 
великобритания: Великобритании Великобритания 
сотрудничество: сотрудничеству сотрудничестве сотрудничества 
диван: диване 
скандальный: скандальным 
казань: Казани Казань 
бобёр: Бобра 
разобраться: разобраться 
воспитанник: воспитанники воспитанников 
поиск: поиском поиске 
оно: оно 
землетрясение: землетрясения 
двигатель: двигатель 
привносить: привносит 
протяжение: протяжении 
долг: долгом 
покупаться: покупались 
голевой: голевое голевую 
версия: версию 
канадец: канадцев канадца канадцы 
вы: вами 
паук: Паук 
необходимо: необходимо 
тянуть: тянет Тянет 
пользовательский: Пользовательская пользовательские 
вообще: вообще Вообще 
правильный: Правильная Правильное правильных правильном правильный 
кагоцел: Кагоцел 
сознательно: сознательно 
ежедневно: ежедневно 
отрыв: отрывом 
критиковать: критиковать 
городок: городков 
они: ними 
возле: возле 
промежуточный: промежуточном 
преимущество: преимуществе преимущество 
пробный: пробный 
район: районе 
возможность: возможность возможностях 
свист: свист 
капустин: Капустин 
карьерный: карьерный 
классный: классный 
спорткостюмах: спорткостюмах 
счастие: счастье 
руднев: Руднев 
уйти: ушли уйди уйти уйдет ушло 
ничья: ничья 
горизонт: горизонте 
сформироваться: сформировались сформировалась 
защита: защите защиту 
вечно: вечно 
вселять: вселяют 
быстрый: быстрый быстры быстрая быстрее 
гербулова: Гербулова 
опыт: опыт опытом опыта 
молодец: Молодцы молодец молодцы 
калитка: калитку 
помочь: помочь Помочь помогли помогло 
зимний: зимние Зимних зимнюю 
суметь: сумеет 
мета: Мете 
раскритиковать: раскритиковал 
спорить: спорить 
континент: Континента континентов 
решать: решаемой Решайте 
напротив: напротив 
серебряков: Серебряков 
питтсбург: Питтсбург Питтсбургом Питтсбурга 
вспоминать: вспоминают вспоминая вспоминать 
кстати: кстати Кстати 
сидеть: сидел 
пожалуй: пожалуй 
уведомить: уведомила 
создать: создать создали создал 
николаевич: Николаевичем 
найти: нашел 
ответственность: ответственность 
подбор: подбор 
предоставлять: предоставляют 
резнорсегодня: Резнорсегодня 
цэсемьэрвчера: цэсемьэрвчера 
заинтересованный: заинтересован 
право: прав право права Права 
заметка: заметке 
пожалуйста: пожалуйста 
горнолыжный: Горнолыжный горнолыжном 
тч: тч 
российско: российско 
костича: Костича 
легионер: легионеров легионерами легионера легионером 
пиджак: пиджаке 
приезжать: приезжают 
консульство: консульства 
легенда: легендам легенда легенд 
алексей: Алексей 
потеряться: потерялся 
сегодня: Сегодня сегодня 
против: против 
идеал: идеале 
никуда: никуда 
квалификационный: квалификационный 
фирменный: фирменный 
ребята: ребята ребят 
раздавать: раздавали раздают раздавал 
ткачёв: Ткачев 
возбудиться: возбудились 
язык: языке языку язык языка 
окно: окон 
нормально: нормально 
практически: практически 
расположение: расположение 
чок: Чок 
совершать: совершает 
угол: угла углу углах 
созреть: созрели 
звонок: звонков 
запретить: запрещена 
телевизор: телевизору 
горный: Горные горные 
отмечать: отмечать 
лаура: Лаура 
лозунг: лозунги ЛОЗУНГИ 
пилот: пилоты 
повлиять: повлияла повлияет 
хайруллин: Хайруллин 
библиотека: библиотеке библиотеку 
постараться: постараться постараемся постараются 
стаканчик: стаканчик 
исход: исходе 
плас: Плас 
берлинский: берлинская 
тампу: Тампу 
ха: ха Ха 
акрон: Акроном 
калининград: Калининград 
россия: Россией Россию России Россия 
подробный: подробная подробное подробнее 
феноменальный: феноменальная 
отличие: отличие отличии 
мишка: мишек 
павловсегодня: Павловсегодня 
учитывать: Учитывая учитывая 
самоотдача: самоотдаче 
светить: светит 
покинуть: покинули 
южный: Южная 
сообщать: сообщает 
национализм: национализмом 
допуск: допуск 
идиот: идиот идиотов 
дружба: дружбы дружбе 
виктор: Виктор 
объявить: объявил объявят 
тупой: тупая 
дядя: Дядя 
мушкетёр: мушкетеры 
сварить: сваришь 
франческо: Франческо 
обезопасить: обезопасить 
поправимый: поправимо 
антураж: антураж 
заголовок: заголовки заголовках 
бронзовый: бронзовую бронзовые 
хафизуллин: Хафизуллин 
винисиуса: Винисиуса 
мексика: Мексике 
сонный: сонный 
московский: Московский московское московской московскому 
память: памяти 
соответствие: соответствии соответствие 
разбивать: разбивают 
лилль: Лиллем 
женский: женского женская 
сало: Салах 
поезд: поезда 
значить: значат 
оклад: Оклад оклада 
валеев: Валеев 
известно: известно 
ирина: Ирина 
экспресс: Экспресс Экспресса 
юнайтед: Юнайтед 
постить: постить 
пускать: пускали 
журналистика: журналистика 
план: планов плане план планах плана 
пиво: Пиво 
атаковать: Атакующий атакующий 
шведский: шведских шведской шведского Шведский 
элан: Элана 
заменить: заменен заменит заменили 
челябинский: челябинский 
элверссегодня: Элверссегодня 
слабо: слабо 
американский: Американский американские 
брать: берут бери Брал брали беру 
коллектив: коллектив 
привыкать: привыкать 
стакан: стаканов 
йоганнес: Йоганнес 
прицепиться: прицепился 
герой: героем 
косячит: косячит 
исполнить: Исполнят 
видать: видали 
спустя: спустя 
ограничение: ограничениях ограничениями 
произвольный: произвольной произвольный 
беловвчера: Беловвчера 
бестолковый: БЕСТОЛКОВАЯ 
гилбертвчера: гилбертвчера 
дать: дали дал дать дадим Дай даст дадут 
выбраться: выбраться 
прописаться: прописалась 
айлендерс: Айлендерс 
пополнение: пополнение пополнения 
участие: участия участием участии участие 
забрасывать: забрасывать 
энглвчера: Энглвчера 
разный: разные разных 
монстр: монстра 
лаурентис: Лаурентис 
балаган: Балаган 
назначение: назначения 
фрейд: Фрейду 
предпочитать: предпочитаешь 
продавать: продавать продавали 
сю: СЮ 
повидать: повидали 
нравиться: нравится 
снятие: снятии 
колесниковвчера: Колесниковвчера 
очень: очень Очень 
развязка: развязкой развязка 
ирония: Ирония Иронии 
устюгов: Устюгов 
есть: Тено 
гафер: Гафер 
сказка: сказке 
гений: гений гениях 
напоследок: напоследок 
рассказывать: рассказывают рассказывал 
изобилие: изобилия 
временами: временами 
расслабиться: расслабиться 
вещатель: вещателем 
десант: десанта 
отчёт: отчет 
превратить: превратили 
магнитка: Магниткой Магнитку Магнитка 
шаркс: Шаркс 
профдеформация: профдеформация 
ясно: ясно 
отрасль: отрасли 
подумать: подумали подумал подумать 
сбор: сбор 
заранее: заранее 
протокол: протоколам протоколы 
штанга: штанга 
сразу: сразу Сразу 
прийдет: прийдет 
жильё: жилье 
причём: причем 
минск: минск Минск 
кол: колом 
гу: Гу 
медицина: медицине медицины медицина 
сякой: сякие 
назаров: Назаров 
готовить: готовить 
инсайдер: инсайдеры 
пинкманвчера: Пинкманвчера 
редко: редко 
давний: давние 
интерес: интересом интерес Интереса 
мозг: мозга мозги 
фетиш: фетиш 
покончить: покончено 
приемлемый: приемлемый 
больший: Наибольшая большую Большая наибольшую большая 
поздравить: поздравил 
претендент: претендентами претендент претенденты 
самонова: Самонова 
пинать: Пинающий 
бакс: баксами 
пространство: пространства 
романоввчера: Романоввчера 
дух: духом духе 
необычно: необычно 
партизан: Партизан 
сквер: Сквер 
легендарный: легендарные легендарного 
дарья: Дарья 
мир: мире мира 
сообщаться: сообщалось 
зайца: Зайц 
сожаление: сожалению 
мем: мемом 
традиционно: традиционно 
профессионал: профессионалов 
жаль: жаль 
факт: факт факты факту 
настольный: Настольный 
чувство: чувство 
бросить: бросить бросил 
развлекать: развлекает 
беспроигрышный: беспроигрышную 
майами: Майами 
очко: очков очко очка 
цель: целях 
шедевр: шедевров шедевр 
ак: Ак 
рушиться: рушится 
козлов: Козлов 
размер: размером 
к: ко 
глубинка: глубинку 
потеря: потеря потерь 
признак: признак 
затем: затем 
мальчишка: мальчишки 
крис: Криса Крис 
йозики: йозики 
гузякавчера: гузякавчера 
удовлетворить: удовлетворен 
шарлатан: шарлатанов 
пожелать: пожелал 
аншлаг: аншлаг аншлага 
соревноваться: соревноваться 
модератор: модератором 
наголо: наголо 
деться: делся 
терпение: терпения 
войти: войти вошли 
благотворительность: благотворительность 
айленда: Айленда 
симпатичный: симпатичные 
информация: информацией информацию 
пользователь: пользователям пользователей Пользователь пользователем 
тягомотина: тягомотину 
сойтись: сойдутся сошлись 
игорь: Игоря Игорем Игорь 
внутри: внутри 
тренировка: Тренировки тренировки 
слоупстайл: слоупстайл 
достоинство: достоинства 
маленький: меньше маленькие 
закрепиться: закрепиться 
армеец: Армейцами 
парень: парень парни парню Парни Парню 
направиться: направилась 
выстраивать: выстраивает 
канунниковавчера: Канунниковавчера 
псж: ПСЖ 
минутыпожадуй: минутыпожадуй 
актив: активе 
неудача: неудач неудачах 
неймар: Неймар 
каролина: Каролина Каролиной 
зацикленный: зациклен 
комфортно: комфортно 
дата: даты дата Дата 
обновить: обновил 
хет: Хет хет 
вспоминаться: вспоминается 
крк: КРК 
завязка: завязку 
букмекер: букмекеров Букмекеры 
сначала: сначала 
скудре: скудре 
лист: листа 
заработок: заработке 
кейша: Кейша 
рамка: рамках 
тащить: тащит 
брянскийвчера: Брянскийвчера 
вершина: Вершине 
безумно: безумно 
отсюда: отсюда 
близко: близко 
спортсе: спортсе 
проводить: проводят проводить 
входить: входят 
бостон: Бостона Бостоном 
привести: привели 
озвучить: озвученные 
испанский: испанского 
закари: Закари 
декабрь: декабря 
святослав: Святослав 
передать: Передав передадут 
отращивать: отращивать 
блинтак: блинтак 
количество: количества количеству количестве количество 
чешский: Чешский чешские 
встреча: встрече встреча Встречу встреч встречу Встреча встречи 
каменев: Каменеве 
осудить: осудил 
андерссон: Андерссон 
подавлять: подавляющее 
зря: зря 
назад: назад 
армия: Армия армия армию 
приобрести: приобрела 
мягко: мягко 
фейк: фейк 
букин: Букин 
позитивный: позитивные 
отрабатывать: отрабатывать 
хаф: хаф 
карман: кармане 
баранка: баранкой 
чимаев: Чимаев 
многое: многого Многое многом многое 
уверенно: уверенно 
тими: Тими 
бокс: Бокс 
раздувать: раздувать 
довольный: Довольны 
утро: утра 
разочаровывать: разочаровывать 
тысяча: тысячи 
срок: срок 
евро: евро 
доротея: Доротея 
лицо: лице 
оптимизм: оптимизмом 
неверно: неверно 
наверное: Наверное наверное 
немного: немного 
завершить: завершен завершит 
генменеджере: генменеджере 
выделяться: выделяется 
диагноз: диагнозы 
зелёнка: зеленке зеленка 
сниматься: снималась 
рассмешить: рассмешило 
черта: черта черт 
латыпов: Латыпов 
шинник: Шинника 
драка: драке 
огюствчера: Огюствчера 
запустить: запустить 
весело: весело 
умереть: Умер умри 
дичь: дичь 
похожий: похожих похож 
отель: отелем отеля 
звёздный: Звездный звездно 
инструкция: инструкция 
спортсмен: спортсмена Спортсмен спортсмены спортсменов спортсменам 
роднина: Роднина 
облом: обломом 
рождество: Рождество 
талантливый: талантливому 
крутой: крутые крут 
антон: Антон 
уокер: Уокер 
послать: пошли 
соединить: Соединенных 
нижнекамцев: нижнекамцев 
собрать: собравший 
договор: договоры 
рано: рано Рано 
родитель: родителей родители 
кожаный: кожаном 
александр: Александром Александр Александра 
нефтяник: Нефтяники 
мероприятие: мероприятий 
смелый: смелый 
выясниться: выяснилось 
защищать: защищать 
швеция: Швецией Швеция Швеции 
август: августа 
годный: годная 
спринт: спринте спринт 
ванда: Ванда 
тюмень: Тюмени Тюмень 
ты: тебе Тебе 
хабаровский: хабаровский 
деградация: деградацией 
капризов: Капризова 
набраться: наберемся 
спецпроект: Спецпроект 
снукер: Снукер 
посольство: Посольство 
вэ: вэ 
специя: Специю 
иго: Ига 
негр: неграми 
оплата: оплаты 
страшный: страшным страшен страшнее страшный страшного 
тристан: Тристан 
василий: Василий 
мариама: Мариама 
янник: Янника 
добиваться: добивается 
область: области область 
марин: Марину 
отменять: отменяет 
француз: французы французами 
рон: Рону 
строчка: строчку 
тег: Теги 
уверенность: уверенностью уверенности 
волейбол: волейбол Волейбол 
хавбек: Хавбек Хавбеку 
полузащитник: полузащитник 
фигурный: Фигурное фигурном фигурному фигурного 
буркинвчера: Буркинвчера 
ои: ОИ 
надоесть: Надоел 
установка: установку 
получать: получают получает получать 
истерика: истерика 
юха: Юха 
особенность: особенностях 
посещаемость: посещаемостью посещаемость 
откуда: Откуда откуда 
отсутствие: отсутствием отсутствие 
текстовый: текстовую Текстовый 
элементарный: элементарных элементарного 
камал: Камалов 
достигать: достигает 
пропуск: пропуск 
начинать: начиная начинал начинаешь начинать начинаю 
доступный: доступна доступен доступны 
здоровье: здоровьем здоровья 
богатый: Богатые 
хозяин: хозяева хозяев 
доигрывать: доигрывать 
конор: Конор 
доход: Доходы 
прокуратура: прокуратура 
небольшой: небольшая небольшим 
падение: падения 
связать: связана связано 
конечность: конечностей 
георгиев: Георгиев Георгиева 
санный: санный 
осложнение: осложнений 
муштаков: Муштаков 
глашатай: глашатай 
седьмой: седьмое 
софья: Софья 
возникать: возникали 
подвести: подвела подвел подвести 
влево: влево 
рассмотреть: рассмотреть рассмотрены рассмотрит 
ия: ий 
определённо: определенно 
джуниор: джуниор 
процесс: процессе процесс 
уверить: Уверены 
красавчик: красавчик Красавчик 
сплоховать: сплоховал 
обогнать: обогнал 
зарабатывать: зарабатывают 
наливать: наливать 
пяо: Пяо 
раздать: раздали раздать 
растяжение: растяжение 
отвлечься: отвлеклись 
анна: Анна 
залог: залог 
кирилл: Кириллом Кирилл 
кристоф: Кристоф 
бензема: Бензема 
завод: завода заводе завод 
откат: откат 
рамис: Рамис 
рик: Рик 
ступак: Ступак 
заборостроительвчера: Заборостроительвчера 
богатырь: богатырь 
биг: биг 
сосед: соседи соседей 
эйр: эйр 
являться: является 
губерний: Губерниев 
чисто: чисто Чисто 
кейна: кейна Кейна 
км: км 
дневный: дневная 
назадощущение: назадощущение 
конец: концов конце конца концу 
ответ: Ответ ответа 
малкин: Малкин 
переезд: переезда 
фонбет: Фонбет 
соприкасаться: соприкасаются 
непряева: Непряева 
параметр: параметров 
отступить: отступили 
винисиусе: Винисиусе 
коннор: Коннор 
понимание: понимание 
знакомиться: Знакомьтесь 
телевизионный: телевизионные 
прыжок: прыжки Прыжки прыжках 
слон: слона 
вход: входа 
шлем: шлема 
жилой: жилого 
реагировать: реагировать 
великий: величайшим 
карета: каретой 
исправлять: исправлять 
никакой: никаких Никакого никакие никакой 
ретроматч: ретроматч 
округ: округе 
хегстад: Хегстад 
транслировать: транслировать транслирующая 
петька: Петьки 
успех: успехов успех 
подход: подходом 
воевать: воюют 
корректно: корректно 
поповсегодня: Поповсегодня 
возвращение: возвращении 
формирование: формирование 
дом: дома домах дом Дома 
ненадёжно: ненадежно 
фенербахче: Фенербахче 
пить: пьют Пил 
появление: появление 
удостаиваться: удостаивается 
гончаровасегодня: Гончаровасегодня 
согласиться: соглашусь 
посторонний: Посторонним 
везину: Везину 
штюцле: Штюцле 
замечать: замечает 
лидировать: лидирует 
техничный: Техничная 
луис: Луис Луису 
поляк: поляками 
коммунист: Коммунисты 
мендеш: Мендеш 
минь: Мини 
дницы: дницы 
вместе: вместе 
хабаровск: Хабаровска 
пуша: пуше 
каска: Каски 
вологда: Вологде 
враг: врагам 
диалектика: диалектика 
карабах: Карабах 
удивляться: удивляюсь 
минай: Минаем Миная 
каменский: Каменский 
ад: ада 
экзотический: Экзотические 
пример: пример примеру Пример 
дебютировать: дебютировали 
ветер: Ветра 
надёжный: надежнее 
роман: Романа Роману 
млн: млн 
прокомментировать: прокомментировал 
мандовошкин: мандовошкин 
пресс: пресс 
трек: трек треке трека 
боруссия: Боруссия 
умение: умения умение 
потрогать: Потрогать 
восьмой: восьмую 
устраивать: устраивают устраивает 
патриот: патриотами патриотов 
потерять: потеряет потерял 
боль: боль 
онлайн: онлайном 
зп: зп 
мастерство: мастерство мастерства 
сморщковвчера: Сморщковвчера 
прозябать: прозябает 
анахайма: Анахайма 
обморок: обмороки 
успевать: успевали 
туда: туда 
размазать: размазал 
выбиваться: выбиваются 
пополам: пополам 
реальность: реальности 
екатерина: Екатерина 
положить: положено положил 
штамповать: штампуя 
жорж: Жорже 
йозе: йозе 
пять: пять Пять пяти 
баскетболист: баскетболисты 
сафон: Сафоном 
сборный: сборных 
дедлайн: дедлайне Дедлайн 
мегаспорт: Мегаспорт 
красота: красоте красот красоту 
мария: Мария Марии 
включить: включили включила 
пресекаться: пресекалась 
чудесно: чудесно 
няттинен: Няттинен 
вхл: ВХЛ 
благодарность: благодарность 
ске: СКЕ 
вечный: вечный 
итд: итд 
хольмефьорд: Хольмефьорд 
взаимодействие: взаимодействия 
инновационный: инновационного 
вбрасывать: вбрасывают 
хрень: хрень 
качественно: качественно 
зык: Зыков 
остановка: остановка 
недостаток: недостаток 
мосгорсудсегодня: Мосгорсудсегодня 
марк: Марк 
логика: логика логике 
искать: ищите искать 
накануне: Накануне 
даром: даром 
ехать: едет едут 
концовочку: концовочку 
гигант: гигант гиганте 
микрорайон: микрорайоны 
провинция: провинциях 
сворачивать: сворачивать 
опубликовать: Опубликовал Опубликованы 
курс: курсе 
переиначивать: переиначивает 
лично: Лично лично 
требование: требования 
изучение: изучению 
мужчина: мужчины мужчин Мужчины мужчинами 
лапотник: лапотников 
низкий: низкую 
посоветоваться: посоветовались 
запредельный: запредельный 
хэмилтон: Хэмилтон 
предложение: предложение предложении 
показатель: показателям показателю показатель 
пробка: пробки 
желаемый: желаемая 
кнр: КНР 
олег: Олег 
джош: Джош 
личный: личный 
томкинсом: Томкинсом 
ья: ья 
континентальный: Континентальной Континентальная 
неудобный: неудобный 
алабинвчера: Алабинвчера 
соареш: Соареш 
пусть: пусть Пусть 
выбор: выбора выбор 
пока: Пока пока 
дэвид: Дэвид 
разрешить: разрешила разрешил 
тампе: Тампе 
менять: меняют менял менять 
сдать: сдали сдадим сдал 
бильярд: Бильярд бильярд 
книга: книг 
трахнуть: трахни 
сравнить: сравнил сравнить Сравните 
окончательный: окончательный 
треть: треть 
автор: авторы 
ферстаппен: Ферстаппен 
описать: описал 
душа: душой душу 
гладкий: Гладкий 
макс: Макс 
температура: температурой температуру 
сунуть: Сунь 
будущий: будущих будущие 
удивить: удивили 
свет: свет света 
доступ: доступа 
восточный: Восточной 
сидоров: Сидоров 
борис: Борис 
ксения: Ксения 
радовать: радовать радует 
планктон: планктона 
крайний: крайней 
артур: Артур 
данные: данным 
занижать: занижать 
риторика: риторику 
гореева: Гореева 
эдуард: Эдуард 
тестировать: тестировало 
телеграмма: телеграмм 
необязательный: необязательна 
хрустальный: Хрустальном 
логинов: Логинов 
лонг: Лонг 
дуть: дуть 
сэйва: сэйва 
ученица: ученицы 
значительно: значительно 
прям: Прям прям 
глядеть: глядя 
определение: определение 
дэя: дэй 
отзывчивый: отзывчивые 
нищий: нищих 
петербургский: петербургского 
застолбить: застолбить 
опрос: Опрос 
касильяс: Касильяс 
относиться: относятся 
упасть: упасть 
наступить: наступил 
учёт: учета Учет учетом 
пайп: пайп 
коуч: коуч 
датчанин: датчанами 
ехидствовать: ехидствуйте 
рейра: Рейра 
карим: Карим 
пингвинятник: пингвинятник 
томас: Томас 
максим: Максим Максима 
китаец: китайцев 
ломиться: ломилась 
подвергаться: подвергается 
дзюба: Дзюба 
возня: возню 
пробить: пробил 
мейерс: Мейерс 
держать: держать держите 
калория: калорий 
ненужный: ненужные 
эталон: эталон 
мотивация: мотивация 
высказаться: высказалась высказался 
большунов: Большунов 
начальник: начальника 
заслужить: заслужило заслужить 
обсуждение: обсуждения обсуждениями 
трудолюбие: трудолюбие 
гарантировать: гарантировал 
растянуться: растянуться 
давно: давно Давно 
продвижение: продвижению 
овертайм: овертайме Овертайм овертайм 
опухоль: опухоль 
бриньоне: Бриньоне 
старый: старо Старая старый 
украсть: украл 
разборка: разборки 
диабет: диабет 
справка: справка 
лето: летом лета 
эпичный: эпично Эпично 
уефа: УЕФА 
хитрый: хитрый хитрей 
царь: царь 
лицензирование: лицензирования 
олигарх: олигархов 
значиться: значится 
ведомство: ведомствах 
оренбург: Оренбургом 
погнать: Погнали 
перформанс: перформанс 
эмблема: эмблему 
назначить: назначен назначат 
туалет: туалетах Туалет туалеты 
поддерживать: поддерживают поддерживает поддерживать 
поход: походу похода 
уильямс: Уильямс 
блеск: блеска 
шалун: шалунов Шалунов 
совершенно: совершенно 
нюанс: нюансами 
примечательно: Примечательно 
позади: позади 
рассчитать: рассчитаны 
сульшер: Сульшер 
майя: Майе 
бог: Бога бог 
отличиться: отличился 
смех: смехом 
претендовать: претендуют 
путь: Путь путь 
судить: Судя судя судить 
обмануть: обмануть 
абсолютно: абсолютно 
кросс: кросс кроссе 
объяснение: объяснение 
воронка: Воронок 
достигнуть: достиг 
операция: операция 
юве: Юве 
род: родом 
вегорст: Вегорст 
теоретический: теоретическая 
ярослав: Ярославе 
совать: Суй 
унылый: унылый унылое 
вроде: Вроде вроде 
разумный: разумное 
выздоровление: выздоровление 
мф: МФ 
кондачок: кондачка 
современный: Современное 
гусев: Гусев 
режес: Режес 
трактор: Трактор Трактором 
бравос: Бравос 
местный: Местные местных 
пионер: пионерам 
джа: Джа 
пустота: пустота 
силовой: силовым силовых 
хо: Хо 
боец: бойцы боец бойца 
происходить: происходит происходящее 
поправить: поправит 
мэйсона: Мэйсона 
сходить: сходи сходить 
повториться: повториться 
вкладывать: вкладывал 
оберегать: Оберегал 
весьма: весьма 
фиал: Фиалу 
гендиректор: Гендиректор 
брыльске: Брыльске 
наступать: наступает 
попугай: Попугаев 
превзойти: превзошел 
хетафе: Хетафе 
убедиться: убедиться 
повысить: повысить 
георгий: Георгий 
намерить: намерена 
сам: Сами сами само 
чей: чей 
сузить: сужу 
единый: Единая Единой единой единая 
макморрис: Макморрис 
долгий: долгое долгие Долгих 
ставка: ставку 
силикон: силикона 
интернет: интернете 
победный: победный 
снять: сняли снять 
инерция: инерции 
коламбусе: Коламбусе 
окончание: окончания 
эффектный: эффектный 
хронический: хронического 
источник: Источник источников 
карантин: карантин 
здоровый: здоровы 
кк: кк 
расклад: расклад 
семён: Семен 
водярасегодня: Водярасегодня 
суперлига: Суперлиге Суперлига 
нефтехимик: Нефтехимик Нефтехимиком 
выгорание: выгорание 
оснастить: оснащенный 
атрибутика: атрибутику 
лайхе: Лайхе 
позитив: позитиве Позитива 
диверсия: диверсия 
туляк: туляка 
пена: пена 
кожа: Коже 
гражданин: Гражданин 
столкновение: столкновения 
проигрывать: проигрывает проигрывать 
понятие: Понятия 
самопожертвование: самопожертвования 
певица: Певица 
уфк: УФК 
подготовка: подготовку подготовке 
добавить: Добавить добавить добавлена 
млс: МЛС 
рублёв: Рублев 
бадаются: бадаются 
манера: манере 
воскресный: воскресный 
петров: Петров 
капитал: капиталу 
картина: картины 
бесценный: бесценный 
финальный: финальный Финальная 
прага: Праге 
отвечать: отвечать 
ростислав: Ростислав 
тасовать: тасовать 
начало: началом начала 
двигаться: двигаться двигались 
отредактировать: отредактировали 
шериф: Шериф 
понятный: Понятна понятна 
медлительный: медлителен 
председатель: председатель 
ветла: Ветле 
выкарабкаться: Выкарабкался выкарабкаюсь 
окр: ОКР 
зелёный: зеленую 
беларусь: Беларуси 
особый: особого 
вялый: Вялому 
интересоваться: интересуются 
китай: Китай Китая Китаем 
галатасарай: Галатасарай 
голден: Голден 
фредерик: Фредерик 
подправление: подправление 
гомеопатия: гомеопатию 
жаровцев: Жаровцев 
словения: Словения 
взаимопонимание: взаимопонимания 
безопасно: безопасно 
вэл: Вэл 
помня: помне 
продлить: продлила 
цитировать: цитирует 
эдмонтон: Эдмонтоном Эдмонтона Эдмонтоне Эдмонтон 
рассчитывать: рассчитывать 
кацалапов: Кацалапов 
чувствоваться: чувствовался 
фёдор: Федор 
зук: Зук 
фига: фига 
ампутировать: ампутировали 
больной: больные 
шопе: шопе 
танец: танец Танцы танцах 
рабочий: рабочего 
всеобъемлющий: всеобъемлющего 
тур: тура туров 
побить: побить побьет побил 
недавно: Недавно недавно 
заслуживать: заслуживает 
изменить: изменить изменил Изменили 
уехать: уехать 
имя: имена 
четверг: четверг 
прикол: прикола 
медальный: медальный 
петунин: Петунин 
крепкий: крепкий 
сан: Сан 
шахтёр: Шахтер 
иштван: Иштван 
многочисленный: многочисленная 
хамзат: Хамзат 
лорентсен: Лорентсен 
супергигант: супергигант 
русски: русски 
спать: спать 
глеб: Глеб 
вина: вину 
михаэль: Михаэль 
вашингтон: Вашингтон Вашингтона 
тяжело: тяжело 
блуен: Блуен 
ненормативный: ненормативная 
неожиданный: Неожиданная 
ильясегодня: Ильясегодня 
красный: Красная 
концовка: концовке 
характер: характер характера 
нэшвилл: Нэшвилл 
дортмунд: Дортмунд 
никишин: Никишин 
налоговый: налоговой 
пополнить: пополнив 
состояние: состояние Состояние состоянии состоянием 
луч: Луч лучу 
уимблдон: Уимблдон 
фейерверк: фейерверк 
численно: численно 
крымский: Крымские 
ивановсегодня: Ивановсегодня 
адмирал: Адмирала Адмирал 
правильноесли: правильноесли 
микротравма: микротравма 
сноубордисты: сноубордисты 
берлев: Берлев 
котовсегодня: Котовсегодня 
образовательный: образовательных 
игровой: игровая игрового 
эмоция: эмоциями эмоций 
кузнецов: Кузнецов 
контролировать: контролировала 
молодчик: Молодчик 
поклонник: поклонников 
окладной: окладная 
чтение: чтение 
наука: наук 
зарубиться: зарубятся 
подряд: подряд 
энциклопедия: Энциклопедия 
швейцарец: швейцарцы швейцарцами 
потенциальный: потенциальные 
напрямую: напрямую 
последствие: последствия 
чурилинвчера: Чурилинвчера 
помалкивать: помалкивал 
выбыть: выбыл выбыли 
далеко: далеко 
оценка: оценки оценок 
пулккинен: Пулккинен 
дорабатывать: дорабатывают 
предпосылка: предпосылки 
платёж: платежей 
научно: научно 
вместимость: вместимость Вместимость 
побеждать: побеждать 
штаб: штабом штаб 
среагировать: среагирует 
предприятие: предприятиях предприятиям 
зомбоящика: зомбоящика 
январь: январь января 
цирк: цирке 
заставить: заставить заставишь 
убыточный: Убыточное убыточен убыточное 
булла: Булл 
украшать: украшают 
нба: НБА 
катание: катание катания катанию катании 
товарищ: товарищи товарищ 
жёсткий: жесткий 
сен: Сен 
соотвественно: соотвественно 
логистика: логистикой 
заксобрание: Заксобрании 
нейтральный: нейтральных 
лохо: лохо 
дочка: дочка 
выменять: выменяли 
карпов: Карпов 
конна: Конн 
фогт: Фогт 
доминировать: доминировал 
седой: седых 
настроиться: настроились 
объединить: Объединенные 
генератор: генератор 
эмоциональный: эмоциональном эмоциональный 
валентина: Валентина 
портить: портит 
валидол: Валидол 
кремонезе: Кремонезе 
нефтянушкой: нефтянушкой 
шутить: шутит 
петушок: петушках 
англия: Англии 
фонд: фонда 
блог: блоги Блоги 
организовать: организовать организуют 
этаж: этаже 
выхлоп: выхлоп 
трудно: Трудно трудно 
купаться: купался 
произойти: произошла произошло произошли произошедшего 
хартия: Хартию 
дважды: дважды 
компенсация: компенсации 
яблоко: яблоку 
неужели: Неужели 
культурно: культурно 
чех: Чехи 
перекупщик: перекупщики 
доброжелатель: доброжелателям 
полезность: полезности 
минутпотому: минутпотому 
отборочный: отборочные 
тампы: Тампы 
вагон: вагон 
поступать: поступают 
двоюродный: двоюродный 
трент: Трент 
детра: Детра 
всеармейский: Всеармейский 
конечный: конечное 
конфликт: конфликте 
монобобе: монобобе 
штат: штат Штатов 
кодекс: кодексу 
экипаж: Экипажи 
закончиться: закончился 
риа: РИА 
защитить: защитить 
организация: организациям организации организаций организацию 
тройка: тройке тройку 
пастрняк: Пастрняк 
высокий: высокую высокая высокого 
медведев: Медведев Медведева 
сюй: Сюй 
буря: бурю 
заряд: зарядов 
ход: ход 
бивол: Бивол 
артемий: Артемий Артемия 
имморталок: имморталок 
авоська: авоську 
дальнейший: дальнейший 
балл: балл балла баллов баллами 
джексон: Джексоном 
ваня: Ваню 
пробиться: пробиться 
сизерон: Сизерон 
строение: строения 
брендовый: брендовому 
ради: ради 
фаньюй: Фаньюй 
ивабути: Ивабути 
перерыв: перерыве перерывы перерывах 
фамилия: фамилию 
плотный: плотная 
томкинс: Томкинс 
граница: границу 
гераськин: Гераськин 
чмх: ЧМХ 
фолхабер: Фолхабер 
чэн: Чэн 
нью: Нью 
платье: платьях 
ая: ая 
канадский: канадская 
иностранный: иностранные иностранными 
медведь: медведя 
строительство: строительство 
волонтёр: волонтеров 
туристический: туристических 
больничный: больничном 
лямкин: Лямкин 
насторожиться: насторожился 
однако: Однако однако 
пострадать: пострадавшим 
перевалить: перевалил 
корень: корни 
извиниться: извинился извинились 
рассказ: рассказам 
либо: Либо либо 
мнение: мнению мнения 
кибергонку: Кибергонку 
барыс: Барыс 
лука: Лука 
америка: Америке 
говориться: говорится 
вправо: вправо 
селекция: Селекция 
простсегодня: Простсегодня 
клиент: клиентам 
ампутация: ампутацией 
несмотря: несмотря 
ролан: Ролан 
гави: Гави 
воробьёв: Воробьев 
большинство: большинством большинства Большинство большинство большинстве 
лечиться: лечился 
кидать: кидать 
включиться: включились 
погубить: погубить погубит 
тяжеловатый: тяжеловат 
степанов: Степанова 
очки: очками очкам очках 
лаптев: Лаптев 
отнекиваться: отнекивается 
небоскрёб: небоскреба 
миф: МИФ 
париж: Париж 
уфа: Уфа 
слава: Слава 
заметный: заметны 
центральный: Центрального центральной центральный 
приносить: приносить 
призыв: призывом 
бразилец: бразильца 
палестина: Палестиной 
завоевать: завоевать завоеванный завоевали 
помимо: помимо 
закрывать: закрывает 
подать: подам 
затянуть: затянул 
прохождение: прохождения 
крафт: Крафт 
крест: крест 
кадр: кадры 
фактически: фактически Фактически 
пенсионный: пенсионный 
пул: пулы пуле 
ульяна: Ульяна 
инженер: ИНЖЕНЕР 
обращение: обращения 
отпор: отпор 
кристина: Кристина 
виртью: Виртью 
горение: горения 
сибирь: Сибирь 
рекордный: Рекордные 
телесериал: телесериалов 
орать: орали орать 
конькобежный: конькобежном Конькобежный 
айнтрахтом: Айнтрахтом 
харрикейнз: Харрикейнз 
прокачать: прокачает 
испытать: испытала 
мост: мост 
маннинен: Маннинен 
конь: коней 
коста: Коста 
забанили: забанили 
оттава: Оттаву Оттаве Оттавы Оттава 
безобразно: безобразно 
англосаксонский: Англосаксонскому 
распространяться: распространяются 
разыграть: разыграют разыграно 
иглз: иглз 
трое: Трое 
комплимент: комплиментом 
дэвис: Дэвиса Дэвис 
любимый: любимую 
деятельность: деятельности 
украина: Украине 
кубковый: кубковые 
беда: беда 
мол: мол 
меняться: меняться 
снимать: снимать снимали 
меньшинство: меньшинстве меньшинства 
автодизель: Автодизель 
помогать: помогая помогала 
совесть: совести 
подсказать: подскажут подскажете 
предъявлять: предъявляют 
категория: категории 
перетолкать: перетолкать 
одержать: одержал 
технический: технических технического 
распасться: Распался 
дюрр: Дюрр 
родиться: родилась 
остаток: остаток 
просмотр: просмотра просмотре 
физкультура: физкультуры 
никита: Никита Никиты 
вероятно: вероятно 
шашка: шашками 
юлия: Юлия 
союзник: союзник 
одарённость: одаренность 
коммент: комменты 
позиционный: позиционных 
засуха: засуху 
океан: океана 
ввиду: ввиду 
бубна: бубна 
сломать: сломали 
реклама: Реклама рекламы 
пойнт: Пойнт 
лоб: лоб 
вправе: вправе 
сдвинуть: сдвинутые 
мироноввчера: Мироноввчера 
магнитогорский: магнитогорский 
скажем: скажем 
выявлять: выявлять 
гореть: горит 
гостиница: гостиница Гостиница 
топовый: топовые 
васильеввчера: Васильеввчера 
латвия: Латвия 
нездоровый: нездоровая 
двукратный: двукратный 
отработать: отработает 
оружие: оружие 
джерард: Джерард 
февраль: февраля 
печально: Печально печально 
косово: Косова 
бул: бул 
альметьевск: Альметьевск 
бундеслига: Бундеслига 
слизать: слизали 
оницука: Оницука 
ваучер: ваучерам 
прощальный: прощальную 
скудры: Скудры 
экстрим: Экстрим 
воронков: Воронков Воронковым 
ягра: Ягра ягра 
задание: заданию 
крылов: Крылов 
зато: Зато зато 
кавай: Кавай 
саша: Саша 
тамара: Тамара 
чушь: чушь 
светлана: Светлана 
грабли: грабли 
испания: Испании 
потолок: потолка потолок 
симптом: симптомы симптомами 
заботиться: заботятся 
человечество: человечества 
ханна: Ханна 
кэсси: Кэсси 
нефтяной: нефтяной 
бояться: боимся Боюсь 
надеть: наденут 
крюк: крюка 
наглый: наглое 
сохранить: сохранила 
попробовать: попробовать 
полуфинальный: Полуфинальные полуфинальные 
махачев: Махачев 
звереть: Зверев 
дак: дак 
выполнимый: выполнимо 
послабление: послаблений 
выступать: выступал выступали выступать выступают 
искренний: искренний 
мартин: Мартин 
берлин: Берлин 
автономия: Автономий 
предпочесть: предпочли предпочел 
базель: Базеля 
разговор: разговоре 
вылететь: вылететь 
птб: ПТБ 
надёжность: надежности 
теннисист: теннисисты 
четвертьфинальный: четвертьфинальный Четвертьфинальные 
гаврошвчера: Гаврошвчера 
повод: поводу 
вовлечь: вовлечен 
вадим: Вадим 
зеландия: Зеландия 
просить: просил 
боевитый: боевито 
знакомить: Знакомим 
волк: Волк 
партнёрство: партнерства 
получение: Получение 
фан: фан 
всяческий: всяческими 
разломить: разломлена 
милуоки: Милуоки 
обида: обид обиды 
развлечение: развлечения 
задаром: задаром 
громко: громко 
дно: дна 
непонятно: непонятно 
занимать: занимает 
объективный: объективные 
тд: тд 
рф: РФ 
ковальчук: Ковальчука 
суть: сути 
тихо: тихо 
ларионов: Ларионов 
провокационный: провокационными 
перекрёстный: перекрестные 
тарьей: Тарьей 
лямов: лямов 
хотя: Хотя хотя 
буркинсегодня: Буркинсегодня 
продолжить: продолжит 
бумага: бумаге 
крым: Крыму 
баранов: Баранова 
покидать: покидать 
малый: Малый малый меньшем 
ммг: ММГ 
свежий: свежая 
бухгалтерия: бухгалтерия 
терпила: терпилами 
письмо: письмо 
вежливый: вежливы 
елабуга: Елабуга 
ярославль: Ярославле Ярославль 
макгрегор: Макгрегор 
константин: Константин 
кучер: Кучеров 
победоносный: победоносный 
высота: высотах высоты высотам 
подогреваться: подогревается 
мск: Мск мск 
шмидт: Шмидт 
тов: тов 
равняться: равняюсь 
содействие: содействие 
выбывание: выбывание 
форум: Форумы 
вратарский: вратарский 
сиэтл: Сиэтлом Сиэтл 
заменять: заменяют 
намекать: намекаю намекают 
четвёрка: четверки 
прорубь: прорубь 
честно: честно 
проанализировать: проанализировали 
ссыкливой: ссыкливой 
туризм: туризма 
омрачиться: омрачилась 
абдулаеввчера: Абдулаеввчера 
преисподняя: преисподней 
судейство: судейство 
набирать: набирать 
редкость: редкость 
еле: еле 
полно: полно 
вернуться: вернутся вернуться 
политик: политиков 
отец: отца 
катастрофический: катастрофическая 
елизавета: Елизавета 
очковый: очковый 
штраф: штрафу штрафа штрафы 
зрелищно: зрелищно 
цэсемьэрсегодня: цэсемьэрсегодня 
банально: Банально 
питание: питание 
камавинга: Камавинга 
далее: далее 
тюрьма: тюрьме 
скучно: скучно 
касатка: касатка 
делить: делить 
честь: честь 
лечить: лечил 
находиться: находятся находится 
влюбляться: влюбляться 
близкий: близок 
девушка: девушка девушку 
редакционный: Редакционные 
приходиться: приходится 
давид: Давид 
подмышка: подмышку 
кино: Кина 
ученыйконечно: Ученыйконечно 
коля: Коля 
номинация: номинация 
выгонять: выгонял 
верхний: верхнюю 
страдать: страдает 
начаться: началось начнется 
подлец: подлецы 
зариповвчера: Зариповвчера 
флаг: флаг 
отказывать: отказывают 
свалить: свалили 
пообщаться: пообщаться 
вклад: вклад 
ник: Ник 
аризона: Аризона 
бавария: Бавария 
амур: Амуру 
бабцовсегодня: Бабцовсегодня 
свисток: свистка 
привлечь: привлекут 
допускать: допускают 
отметить: отметил 
алекс: Алекс 
удобство: удобства 
жамнова: Жамнова 
дайджест: дайджест 
техника: техникой 
вирер: Вирер 
печаль: печалью 
работоспособность: работоспособности 
восстановить: восстановивший 
темп: темпами 
проверять: проверял проверяют 
знатный: знатная 
хубер: Хубер 
закусить: закусить 
славик: Славик 
миннесоту: Миннесоту 
подобный: подобное 
стержень: стержнем 
июнь: июня 
погода: погоду 
юлаев: Юлаев 
движение: движения 
дубравка: Дубравка 
связь: связей 
намного: намного 
реальный: реальная 
гребля: Гребля 
статусный: статусные 
рисование: рисованию 
дипломчика: дипломчика 
заработать: заработал 
шипачев: Шипачев 
галактика: галактики 
приложение: приложении 
столетие: столетие 
удовольствие: удовольствия удовольствие 
незабивные: незабивные 
насчитать: насчитали 
попадание: попадание 
хвалёный: Хваленая 
стасян: Стасян 
праймовый: праймовый 
прыткова: Прыткова 
фигура: фигуры 
фехтование: Фехтование 
случай: случаи случае 
скептически: Скептически 
разгромить: разгромили разгромила 
шесть: шесть 
боеспособный: боеспособный 
эдвардс: Эдвардс 
мастер: мастеров мастером мастер 
останавливаться: останавливаться 
зачёт: зачет 
присоединиться: присоединиться 
леопольдоввчера: леопольдоввчера 
подчеркнуть: подчеркнул 
парусный: Парусный 
случаться: случаются случается 
сессия: сессия 
масса: масс массу 
политический: политическом 
комментировать: комментирую комментировать 
удалённый: удален 
плеер: плеер 
казах: казахом 
карен: Карен 
владислав: Владислав 
швейцарский: Швейцарский 
считаться: считаться 
папа: папа 
моррисси: Моррисси 
кумовство: кумовство 
киселевич: Киселевич 
сон: сон 
припомнить: припомню 
избегать: избегает 
активно: активно 
заплатить: заплатили 
дементьев: Дементьев 
губернатор: Губернатор 
удачно: удачно 
олегвчера: Олегвчера 
якимцеввчера: Якимцеввчера 
дортмундцы: дортмундцы 
потребовать: потребовать 
забавный: забавный 
прижать: прижал 
гул: гул 
екатеринбург: Екатеринбурге Екатеринбурга Екатеринбург 
продукт: продукты 
череповец: Череповца 
трава: траве 
барыса: Барыса 
адрес: адрес 
отрезок: отрезок 
впереди: Впереди впереди 
рисунок: рисунок 
спартак: Спартаке Спартаку Спартаком 
нэшвиллом: Нэшвиллом 
экран: экране 
калькулятор: Калькулятор 
подтираться: подтирался 
газпром: Газпром 
тик: тики 
классно: классно 
хафпайп: хафпайп 
грузия: Грузию Грузии 
кадис: Кадисом Кадис 
падать: падают падайте 
подольский: Подольская 
отказ: отказа 
возобновление: возобновления 
генеральный: Генеральный 
перезапустить: перезапустит 
нил: Нила 
местечко: местечка 
сцена: сцен 
диаш: Диаш 
попытаться: попытается 
повести: повела 
удалять: удаляют 
пятёрка: пятерки пятерок 
ди: Ди 
мфк: МФК 
оттачивать: оттачиваем 
морэнт: Морэнт 
добавочный: Добавочный 
свищев: Свищев 
равно: равно 
стычка: стычке 
статистический: статистическими 
цитата: Цитаты 
властимил: Властимил 
роджер: Роджер 
акмаржан: Акмаржан 
деревня: деревня 
подстраиваться: подстраивается 
универсальный: универсальный 
шоста: Шоста 
санитар: санитарами 
биться: биться 
выезд: выезде 
северсталь: Северсталь 
крыло: крыльями 
строго: строго 
клонить: клоните 
назначать: назначали 
рамзес: Рамзес 
джордж: Джордж 
подводить: подводят 
ошибиться: ошибиться 
телевидение: телевидение 
живить: ЖИВИ 
неуступчивый: неуступчивыми 
эпидемия: эпидемии 
мингачев: Мингачев 
таковой: таковыми 
кракадилвчера: кракадилвчера 
заключить: заключит 
глупо: глупо 
мазохизм: мазохизм 
мариновчера: мариновчера 
голам: голам 
таварес: Таварес 
бедро: бедром 
ой: ой 
сомневаться: сомневаюсь 
короткий: короткая короткой короткий 
распродажа: распродаже 
мерседес: Мерседес 
борода: Бороду 
нагнуть: нагнут 
зоя: Зои 
побежать: побегут 
циник: циник 
посиделки: посиделок 
нечего: нечем нечего 
депрессивный: депрессивный 
исправить: исправить 
федеративный: федеративная 
сериал: сериале 
тёплый: теплые 
совместный: совместное 
дополняться: дополняются 
неплохо: неплохо 
иметься: имеется 
семья: семья семье 
три: трех 
велеть: велел 
культурный: культурного культурный 
кск: КСК 
полевой: полевые 
срастись: срослось 
мировой: мировом мирового 
официально: официально 
сотрудник: Сотрудники 
девятый: девятый 
эстафета: эстафете эстафета 
усложнить: усложнили 
муха: мухи 
челюсть: челюсть 
завоевание: завоевания 
сепсис: Сепсис 
блестяще: блестяще 
прекратить: прекратит 
лейхтервчера: Лейхтервчера 
голышев: Голышев 
грань: грани 
безбашенный: безбашенный 
подогревать: подогревает 
принадлежать: принадлежит принадлежат 
зомбоящику: зомбоящику 
голубь: Голуби 
италия: Италии Италия 
ерёмин: Еремин 
владивосток: Владивостоке 
тренироваться: тренировался 
прилёт: прилета 
менеджер: менеджер 
классика: классику классике 
хохлачев: хохлачев 
например: например 
аналогично: аналогично 
ох: Ох 
ястребвчера: Ястребвчера 
довести: доведут 
элемент: элементы 
инсульт: инсульт 
хей: Хей 
научить: научить 
русофоб: русофобов 
дончич: Дончич 
домой: домой 
кэйл: Кэйл 
издательство: Издательство 
генконсул: Генконсул 
инет: инете 
покер: Покер 
автоматизм: автоматизма 
конкурс: конкурс 
осторожнееинтересная: осторожнееинтересная 
василевский: Василевского Василевский 
ови: Ови 
даниэлла: Даниэлла 
контекст: контексте 
никлас: Никлас 
чаша: чаше 
формула: Формула 
трудный: труднее 
оливер: Оливер 
тея: Теи 
положение: положение 
заговор: заговоров 
сложно: сложно 
ассоциироваться: ассоциироваться 
киношедевра: киношедевра 
иван: Иван 
мореввчера: Мореввчера 
академичный: академичный 
нижнекамск: Нижнекамск 
швентек: Швентек 
гвардиола: Гвардиола 
кёрлинг: керлинга Керлинг керлинге 
стэйт: Стэйт 
поздно: поздно 
культура: культуры 
модно: модно 
стефан: Стефан 
фон: фона фоне 
шведка: Шведка 
сидоровсегодня: Сидоровсегодня 
малыгинвчера: Малыгинвчера 
тихонов: Тихонов 
множество: множество 
барзэл: Барзэл 
порадоваться: порадоваться 
вничью: вничью 
преследование: преследования 
мчм: МЧМ 
ух: Ух 
даниласегодня: Даниласегодня 
выкачивать: выкачивать выкачивают 
ротенберга: Ротенберга 
мастеровсегодня: Мастеровсегодня 
заблокировать: заблокировал 
напасть: напали 
прямиком: прямиком 
чествовать: чествуют 
переподписали: переподписали 
габориквчера: Габориквчера 
петржела: Петржела 
привоз: привозы 
рассрочка: рассрочку 
овсянников: Овсянников 
москвич: москвичах 
студенческий: студенческих 
норма: норм 
нога: ногой 
серить: Серена 
прикидывать: прикидывали 
скамейка: скамейке 
рикошет: Рикошет 
такогоне: такогоне 
спокойно: спокойно 
даррен: Даррен 
пробовать: пробовало 
открываться: открывается 
выбирать: выбирали выбирает 
польза: пользу 
культовый: культовом 
лишь: лишь 
трансфер: Трансферы 
очередь: очередь 
есения: Есения 
старикан: старикан 
болото: болото 
стопудовый: стопудово 
явно: явно 
боб: Боб 
словенский: словенский 
листочек: листочке 
высокооплачиваемый: высокооплачиваемые 
акробатика: акробатика 
везде: везде 
грошев: Грошев 
отставка: отставку 
материал: Материалы 
кандидат: кандидата 
бабиков: Бабиков 
взамен: Взамен 
покрепче: покрепче 
невысокий: невысокий 
тириль: Тириль 
подгорный: Подгорная 
эстония: Эстония 
винисиус: Винисиус 
диалог: диалогами 
рад: Рад 
вне: вне 
незначительный: незначительными 
господин: господ 
слэм: слэм 
конкурент: конкурентов 
серый: серая серый 
климоввчера: Климоввчера 
гт: ГТ 
часть: часть 
невада: Невада 
евпатория: Евпатория 
параллельный: параллельном 
признавать: признавать 
австралия: Австралия 
дорогой: дорогих 
недоработать: недоработала 
штястны: Штястны 
советский: Советского 
заря: Зари 
свердловский: свердловскому 
латвийский: латвийскими 
бедный: Бедный 
здравствуйте: Здравствуйте 
ассистент: ассистентами 
удивительно: удивительно 
ловить: ловишь 
берутсяя: берутсяя 
тоттенхэм: Тоттенхэм 
привирать: привирает 
звучать: звучит 
перепосев: перепосев 
толкаться: толкались 
праздник: праздник 
уступка: уступками 
хаскерсвчера: Хаскерсвчера 
фийон: Фийон 
монобоб: Монобоб 
стыдоба: Стыдоба 
михаил: Михаил 
руль: руля 
дюрэнт: Дюрэнт 
утренний: утренний 
юниорский: юниорском 
настрой: настроем 
выбить: выбьет 
организатор: организаторами 
очепяточка: очепяточка 
скорее: Скорее скорее 
администрация: администрации администрацию 
стоимость: стоимость 
бэй: Бэй 
ковач: Ковач 
блогер: блогером 
определяться: определялась 
вторник: вторник 
май: мая 
объелсявчера: Объелсявчера 
вятичвчера: Вятичвчера 
национальность: национальностям 
единоборство: Единоборства 
мордвиновсегодня: Мордвиновсегодня 
собеседник: собеседнику 
улыбка: улыбкой 
цун: Цун 
переместить: переместили 
уточнить: уточнить 
улучшить: Улучшим улучшить улучшим 
ивановвчера: Ивановвчера 
аа: ааах 
соседство: соседству 
забронировать: забронировали 
тампой: Тампой 
потихоньку: потихоньку 
хави: Хави 
вряд: вряд 
кс: КС 
переменчивый: переменчиво 
пмж: пмж 
триумф: триумфа 
овцын: Овцын 
шутка: шутку 
карточка: карточек 
водный: Водные 
аспирин: аспирине 
хоуден: Хоуден 
пансионат: пансионат 
лазарет: лазарете 
обойти: обошел 
макларенвчера: Макларенвчера 
завершение: завершения 
накидать: накидали 
метсола: Метсола 
учёный: ученые 
градостроительство: градостроительства 
расслабить: расслабьте 
гораздо: гораздо 
начинаться: начинается 
гость: гостях 
шарп: Шарп 
загрузить: загрузить Загрузите 
ротенбергом: ротенбергом 
рамс: рамсы 
полагать: полагаю 
домашний: домашних 
ромен: Ромен 
рассуждать: рассуждать 
завысить: завышенными 
разом: разом 
медиагайд: медиагайд 
пингвинс: Пингвинс 
адидас: адидас 
полезть: полез 
гандбол: Гандбол 
ассиста: ассиста 
позволить: позвольте 
прикатить: прикатили 
категорически: категорически 
удаваться: удавалось 
католический: католическое 
нелсон: Нелсон 
кризис: кризиса 
бруклин: Бруклин 
злачный: злачная 
сентябрь: сентябре 
макар: Макар 
антисемитизм: антисемитизм 
одолеть: одолел 
удачный: удачная 
приключение: приключения 
перманентно: перманентно 
данька: Данька 
ульяновск: Ульяновск 
атеросклероз: атеросклероз 
напрягать: напрягает 
погром: погромы 
скандалист: скандалиста 
ежегодно: ежегодно 
вылет: вылета вылет 
поножовщина: поножовщине 
задолго: задолго 
посещать: посещать 
спец: спецы 
хэм: Хэм 
хамада: Хамада 
перестраиваться: перестраиваться 
поздний: Позже позже 
бессилие: бессилие 
незрячий: незрячие 
кучербаеввчера: Кучербаеввчера 
бегло: бегло 
натравить: натравят 
цемент: цементом 
привлекать: привлекать 
одурачивание: Одурачивание 
подарок: подарок 
соперничество: соперничества 
точечный: точечные 
тронуть: тронь 
убыток: убытки 
приехать: приехало 
дарить: Дарю 
смолкин: Смолкин 
арсентьеввчера: Арсентьеввчера 
тэйвса: Тэйвса 
гнать: гонят 
махнуть: махнуть 
адекватный: адекватную 
чот: Чот 
меморандум: меморандум 
оскорбительный: оскорбительный 
слабенький: слабенькая 
эпоха: эпоху 
аудитория: аудитория 
шумно: шумно 
наряд: наряд 
невозможно: невозможно 
приковать: приковано 
макароны: макарон 
разрубить: разрубят 
ньюкасл: Ньюкасла 
чен: Чен 
льюис: Льюис 
сей: Сию сих 
габарит: габариты 
предупреждать: предупреждал 
конференция: конференций 
корбан: Корбан 
травевчера: травевчера 
перегиб: перегиб 
яковлев: Яковлев 
воронин: Воронин 
трогать: трогал 
чикнаворян: Чикнаворян 
спутник: спутника 
супергиганте: супергиганте 
джонс: Джонс 
акм: АКМ 
подойти: подошли 
болгарский: болгарский 
потенциал: потенциала 
бочка: бочке 
подтягивать: подтягивать 
встать: встанут 
показательный: показательна 
завести: завести 
круто: круто 
нахождение: нахождения 
лч: ЛЧ 
статья: статьи 
аэробика: аэробики 
йод: йоде 
вводить: вводил 
поначалу: поначалу 
скорость: скорость 
кайло: Кайл 
легальный: Легальные 
стриминговый: стриминговый 
особенно: особенно 
роллинс: Роллинс 
технично: технично 
футболист: футболисты 
называться: называется 
йоонас: Йоонас 
винатцер: Винатцер 
истерический: истерическим 
связывать: связываете 
бойкот: бойкоте 
самозванец: САМОЗВАНЕЦ 
укрепить: укрепить 
раковый: раковая 
ученик: ученикам 
сибирский: Сибирский 
николас: Николас 
стена: стены 
молдавия: Молдавии 
йос: Йос 
сэйв: сэйв 
чайковский: Чайковская 
конёк: Коньки 
привезти: привезли 
поднять: поднять 
кэпхит: кэпхит 
откровенный: откровенную откровенное 
забрать: забрала 
собираться: собираться собирается 
судьба: судьбы 
непрекращающийся: непрекращающийся 
карл: Карл 
почётный: почетный 
логично: логично 
появляться: появлялся 
отличаться: отличаются отличалось 
вовсе: вовсе 
жан: Жан 
дин: Дина 
дебринкета: Дебринкета 
двоякий: Двоякое 
викторовичсегодня: Викторовичсегодня 
теоретически: теоретически 
боярин: бояре 
пропп: Пропп 
вода: воду 
подрастать: подрастающего 
чутьё: чутье 
напоминать: напоминает 
пф: ПФ 
инфраструктура: инфраструктуры 
чашка: чашкой 
нападение: нападение 
договориться: договорились 
отталкивать: отталкивает 
опасно: опасно 
босси: Босси 
сезганов: Сезганов 
кузнецоввчера: Кузнецоввчера 
уютный: уютном 
перестройка: перестройка 
взяться: взялся 
позавидовать: позавидовали 
петрунин: Петрунин 
эл: Эл 
орр: Орр 
заканчивать: заканчивая 
политизировать: политизированные 
лексика: лексика 
хальвор: Хальвор 
усиление: усиление 
еврейский: еврейские 
дружественный: дружественной 
уточнение: уточнение 
правоохранитель: правоохранители 
директор: директор директоров 
допустить: допущены 
столичный: Столичные 
шумный: шумный 
массово: массово 
водка: водку 
нередко: нередко 
поселять: поселяют 
ввезда: ввезда 
неопределённый: неопределенный 
вечером: Вечером 
пожизненный: пожизненный 
слечь: слечь 
северный: Северной 
литва: Литве 
развал: Развал 
коэффициент: коэффициент 
приз: призы 
обитание: обитания 
мощный: мощнее 
еше: еше 
гибсона: Гибсона 
выстоять: Выстояли 
лондонский: лондонском 
пирожок: пирожком 
ах: Ах 
безопасность: безопасность 
админ: Админ 
направление: направлении 
лес: лес 
носилки: носилках 
уважать: уважаю 
творить: творит 
додуматься: додуматься 
шахматы: Шахматы 
красинвчера: Красинвчера 
убийство: убийство 
буквально: буквально 
торговаться: торгуются 
елена: Елена 
никитин: Никитин 
бронза: бронзу 
дебильный: дебильных 
обильный: обильного 
вещь: вещах 
кирьяк: Кирьяков 
обеспечить: обеспечен 
саня: Саня 
медиалига: Медиалига 
смертельно: смертельно 
манчестер: Манчестер 
рейхмен: Рейхмен 
уничтожать: уничтожала уничтожают 
отказываться: отказываться 
хафпайпе: хафпайпе 
двигательный: двигательная 
полезно: полезно 
филадельфия: Филадельфия 
неадекватный: неадекватный 
околохоккейная: околохоккейная 
играться: играется 
шалька: Шальке 
помеха: помехи 
лариса: Лариса 
слить: сольют 
кусок: кусок 
первоуральск: Первоуральск 
