уход: уходы ухода уход уходом уходов уходе 
самый: Самые Самым самое Самый Самое Самая самым самых самый самые самая 
точнее: точнее 
называться: называются называется 
дистанция: дистанции дистанцию 
скрыться: скрылся 
выступать: выступавшие выступать выступает выступала выступаю выступали выступают 
кашшаи: Кашшаи 
футбол: Футбол футболом футбола футбол футболу футболе 
лавров: Лавров Лаврова 
весьма: весьма 
скептически: скептически 
участвовать: участвовал участвует участвовать 
прошлый: прошлый прошлом Прошлый 
лично: лично 
кожухарьсегодня: кожухарьсегодня 
достойный: достойная достойным достойные 
вишенка: вишенку вишенка Вишенка 
внимательный: внимательнее внимательней 
возникать: возникает возникают Возникает 
посвятить: посвященный 
вечер: вечер вечера 
олайян: Олайян 
йокогама: Йокогама 
говориться: говорится 
важный: важный важные важен важны важным Важную важных важнее важное важнейший 
занимать: занимать занимают занимала занимает занимал занимая 
приложить: приложил 
подобный: подобного подобной подобные подобное подобную 
удобно: удобно 
брать: берут брали беру брать брал 
шанс: шанса шанс шансах шансов шансы 
внимание: внимание вниманию 
претендовать: претендует претендуют претендовать 
снизить: снизит 
встретить: встретить 
бровка: бровку бровке 
воден: водене 
вид: видом видов виде виды вид 
день: день дней дни днях дне дня днем 
получить: получить получил получившие получили получит Получит 
выкупать: Выкупать выкупать 
сливочный: Сливочные 
серьёзный: серьезнее серьезном серьезней серьезных серьезнейший серьезную серьезное 
велоспорт: Велоспорт 
игрок: игрока игроках игрокам игроку Игроки игроков игроки Игрок игроками игрок игроком 
половина: половину половины 
кузнецоввчера: Кузнецоввчера 
ресурс: ресурса ресурсов ресурсах 
точный: точных точны точный 
описать: описал описать 
получать: получает получал получать получают получающий 
усложнять: усложняет 
лион: Лиона 
сенкт: Сенкт 
билет: билетов 
отобрать: отобрали 
пропустить: пропустила пропустить пропустит пропустил пропущено пропущенных пропустят пропустили пропустив Пропущенный пропущенный 
синий: синих Сине 
тело: тела 
иллюзия: иллюзия 
необходимый: необходимым необходимое 
поучаствовать: поучаствовать 
хватка: хватку 
зрелищный: зрелищная зрелищный 
доход: Доходы дохода доход доходах 
интересный: интересного интересен интересной Интересные интересные интереснее интересны интересное Интересны поинтереснее 
титул: титулы титула титулом титул титулов 
великий: Великий величайшее великими великих величайшим великой 
парк: Парк 
восприниматься: воспринимается 
время: временам времена времен время Времени времени 
подпеть: подпоем 
бригада: бригада 
общение: общения общение 
февраль: февраля феврале 
замена: замене замену замена заменах замены 
предпринять: предпринять 
рафинью: Рафинью 
посоветовать: посоветовал 
столичный: столичную Столичной Столичная столичной 
откуда: Откуда откуда 
метр: метров 
игорь: Игорь Игорю 
руководитель: руководители 
ноутбук: ноутбук 
помнится: Помнится 
глубина: глубины 
стадион: стадион Стадионе стадиона стадионы Стадион стадионе 
пьяница: пьяница пьяницей 
стыд: стыда 
выставлять: выставлять выставляй выставляют 
результативность: результативностью результативность Результативность 
быстро: быстро 
перекладина: перекладину 
мир: миром Мир мире мира мир МИР Миры 
чистый: чист Чистая чистое чистыми 
машина: машина машине машину 
распространяться: распространялись распространяются 
выйти: выйдут выйдя выйдет вышел вышедшего выйти вышло вышла вышли 
админресурса: админресурса 
форум: форум 
натужно: натужно 
конец: конце конца концу концом конец 
навес: навесе навеса 
напасть: напастей 
данр: данр 
предвидение: предвидению 
нация: нации наций 
аналогичный: аналогичную аналогичная 
крутой: крутых крутая круче крутое 
стерильный: стерильное 
лукас: Лукас 
ждать: ждет ждут Жду жду ждало ждем ждать 
профессиональный: профессиональным профессионального профессиональные Профессиональный профессиональный 
радужно: радужно 
мастерство: Мастерство 
вспоминаться: вспоминаются 
томпсон: Томпсону Томпсоном Томпсона 
ваш: ваше ваши Ваш ваших ваш Вашему Ваши вашими 
краснодар: Краснодар Краснодару Краснодара Краснодаре 
милдронат: Милдронат 
нажимать: нажимать 
факт: факте факту Факты факты факта факт 
команда: Команда команде команду команд Команды команды Команде команда командой командами командах командам 
непредсказуемый: непредсказуемая непредсказуем 
сеть: сети 
переходить: переходил переходили переходит переходить 
забирать: Забирай 
мяч: мячи мяч мячей мячом мяча Мяча мячами 
магазин: магазине магазина 
беспрецедентный: беспрецедентный 
июнь: июне 
сливать: сливать Сливать 
неудачный: неудачного неудачная 
паесу: Паесу 
шуметь: шумит шуметь 
небезразличный: небезразлично 
услышать: услышал услышать 
постоянный: постоянную постоянной 
пропасть: пропал пропало пропала пропасть 
ограничение: ограничениям 
тигр: Тигр 
ошибка: ошибка ошибку ошибок ошибками 
легко: легко Легко 
сложиться: сложится 
океания: Океании 
занять: занял заняв заняли заняла 
коленный: коленную 
вау: вау 
уртадо: Уртадо 
нарваться: нарвались 
дисциплина: дисциплинах дисциплину 
салем: Салем 
вывод: выводу выводы вывод 
подводить: подводят 
основа: основу основе основа 
провалить: провалила провалил 
конкретный: конкретного конкретным конкретный 
копилка: копилку 
решать: решала решать решаема 
пина: Пина 
сельту: Сельту 
предпочитать: предпочитают 
архив: Архив 
образ: образ образом образе образа 
позвонок: позвонки 
становиться: становился становясь становится 
ходить: хожу ходила ходят ходил ходить 
плакать: плакал плакать 
моралист: моралистов 
комментирование: комментированием комментирования 
сослан: Сослан Сослане 
вратарь: вратарем вратаря Вратаря вратарь вратарей 
короткий: короткая 
одинаковый: одинаковым 
миллуоллу: Миллуоллу 
просматривать: просматривали просматривал 
красавчик: красавчик 
аспиликуэтой: Аспиликуэтой 
оформить: оформивший оформили оформил 
свободный: свободных Свободный свободный свободным 
крепкий: крепкий 
нынешний: Нынешние нынешней нынешним нынешних Нынешний нынешний нынешние нынешнем нынешнее 
посчитать: Посчитайте 
пётр: Петра 
заслуживать: заслуживает заслуживают 
сборный: сборных 
употребление: употребление 
традиционный: традиционном 
два: двум Две две двумя 
намерение: намерении 
скучать: скучает скучаю скучаем Скучал 
сравнить: сравнил сравнила сравнить 
водный: Водные водных водном 
невиллу: Невиллу 
карта: карты 
аллен: Аллен 
вестись: ведутся велась ведется 
состоять: состоит 
проявить: проявить проявили 
гудман: Гудман 
дальшену: дальшену 
находиться: находиться находясь находилась находящимся находящихся находятся находился находящиеся находится находящемуся 
защитник: защитником защитников защитник защитника защитнику Защитник защитники 
прочий: прочих Прочие 
пробиваться: пробивались пробивался 
стартовый: стартовый стартового Стартовый 
чернышов: Чернышов 
сбить: сбил 
продолжать: продолжают продолжает продолжать продолжайте 
томпсонвчера: Томпсонвчера 
вовне: вовне 
ингредиент: ингредиентами 
ставка: ставка ставок ставку ставках 
горло: горло горле 
бчк: бчк 
банда: банда 
азербайджан: Азербайджане Азербайджана Азербайджан 
признавать: признаваемые 
дилетант: дилетанты 
комментарий: комментариях Комментарий комментарий 
человек: человеку людям человек людьми человеке человека людей люди человеком Люди 
нарушение: нарушений нарушение нарушением Нарушения нарушения 
оптовый: оптовый 
кондиция: кондициях 
футболист: Футболист футболистов футболистам футболистами футболист футболиста Футболисты футболисты футболистом 
возможно: Возможно возможно 
агент: агентом агентов агента агенты 
безвыигрышную: безвыигрышную 
кроссовер: кроссовер 
конкуренция: конкуренцию конкуренции Конкуренция 
перспектива: перспективе перспективами перспектив 
кровать: кроватью 
кэти: Кэти 
повреждение: повреждений повреждении повреждение 
положить: положил положить 
специалист: специалистом специалиста 
суарес: Суаресу Суареса 
заботиться: заботиться 
алкоголик: алкоголиков 
рассматриваться: рассматривались рассматриваться рассматриваются рассматривался 
подходить: подходят подходит 
тема: теме тема 
новый: новую новейшей новые новой нового новом новый Новый новых новая 
дать: дала даст дал дай дадут дали даны дав дать 
иметь: имеет имея Имеет Имея имеете иметь имеющее имеют имели 
хоккей: Хоккей хоккей хоккею 
крупный: крупная крупную крупным крупной крупных крупные крупнее крупнейший 
владелец: владельцы владельца владельцем Владелец 
альба: Альба 
москва: Москвы Москва Москве 
сериал: сериал сериала Сериал 
заменить: заменить заменил заменили 
сумасшедший: сумасшедших сумасшедшая 
голос: голосов голос 
порог: пороге 
алексей: Алексея Алексей 
трап: Трап 
реализация: реализацию 
пупкин: Пупкин 
выбрать: выбран выбранными выбрал выбрать Выберите выбрали 
супруг: супруга 
балагур: балагура балагуром балагур 
контракт: контракте контракту контрактами контрактов контрактом контракт Контракт контракты контракта 
подпись: подписями 
слово: словах словами Слово словом слово словам слову Слове слов 
пятый: пятого пятая пятом пятым пятое пятый пятую 
ребёнок: ребенок Ребенок детей ребенка детям детьми 
изменить: изменили изменит изменить 
просить: просил просит прошу 
волгарь: Волгарем Волгарь 
подбухивает: подбухивает 
аэропорт: аэропорту 
первый: первом первым первый первого первую первыми Первый первому Первая первой первые Первые Первого Первую первая Первом первых 
морита: Морита 
должный: должным должна должен должны должно 
прописать: пропишут прописано прописана 
отметка: отметки 
чей: чей 
гув: гув 
серенький: серенькое 
поставить: поставил поставить поставит поставили 
минимальный: минимальные минимальным минимальную 
помнить: помнят помню Помнишь помнить помнит помнишь 
валенсия: Валенсией Валенсия Валенсии 
король: Король 
посмотреть: посмотрел посмотрите посмотри Посмотрим посмотрим Посмотри посмотреть 
жуан: Жуан 
топовый: топовую топовая 
испанский: испанский испанских 
будущее: будущего будущее будущем Будущее 
франк: Франком Франк 
игра: играх игр игрой игры игру Играх игре Игры Игр Игра игра 
понимать: понимает понимаешь понимая понимают понимать понимаю понимаете 
жирону: Жирону 
статья: статьей статья Статья статьям статью 
ум: ума умы уме умом 
отставание: Отставание отставание 
случай: случай случае случаи случаях случаев 
начать: начал начать начнут начали начну начнем 
сила: силу силы силам сил силе 
ошибиться: ОШИБСЯ ошибиться ошибся 
логика: логики логика 
смешно: смешно 
жест: жестов Жест жест жеста 
прийтись: придется пришлось пришлись 
преддверие: преддверии 
словенец: словенцами словенцев словенцы 
событие: событие событием событий 
лю: Лю 
крауч: Крауч 
сравнимый: сравним сравнимо 
заключить: заключить заключенных 
неприкосновенный: неприкосновенны неприкосновенными 
установка: установкой установки 
закончиться: закончится закончился закончились закончилась 
отсидка: отсидки 
камавинга: Камавинга 
недовольство: недовольство недовольстве 
крайне: крайне 
соперник: соперникам соперником соперники соперник соперника сопернику Соперники соперников соперниками 
пометить: Пометить 
показать: покажут покажите Показать покажет показав показала показали показать показал 
юрген: юрген Юргена Юрген 
мальоркой: Мальоркой 
теннис: теннис Теннис 
перекрыть: перекрыли 
медиалига: Медиалига 
италия: Италия италии Италией Италии 
решение: решение решения решению Решение 
дзаппакоста: Дзаппакоста 
раунд: раунда раунд 
разница: разницей разнице Разница разницы разницу разница 
феликс: Феликсу феликс Феликса Феликс 
стопудовый: Стопудов 
копенгаген: Копенгаген Копенгагеном Копенгагена 
европейский: европейской европейских европейский европейские Европейский европейском 
владимировичсегодня: Владимировичсегодня 
взять: взяли взятый возьмут взявший возьмет Возьми взять возьми взял взятых 
смотреть: смотрели смотрим Смотри смотрю смотрите смотреть смотрят смотрел Смотрите Смотря смотрит смотришь 
ник: ник ником 
реализовать: реализовать реализовал 
разрушение: разрушение 
приоритет: приоритете приоритет приоритетах приоритетом 
допинг: допинга допинг допинге 
однакотогда: однакотогда 
мадридский: мадридское мадридских мадридский Мадридский мадридскому 
коул: Коул 
предательство: предательством 
раскусить: раскусил 
эпичный: эпичный эпично 
исправить: исправить исправьте Исправьте 
мюнхеншерина: Мюнхеншерина 
де: де Де 
мясник: мясников 
уголовный: уголовному уголовном уголовным уголовные 
торопиться: Торопитесь 
выдать: выдадут выдали выдал выдала Выданы выдан выданы выдать 
хороший: Лучший хороший Лучшими хорошем Лучшим хорошими лучшие лучшем лучшую хорошим получше лучшим Хорошие Лучшая хороши хорошая хорошего лучший лучшему хороша хорош хорошее лучшими хорошие лучшее хорошую Хороший хороших лучшего лучшая лучших 
трансфермаркте: трансфермаркте 
журналист: Журналист журналистами журналист журналистов 
правда: правду 
концерт: концерты концерте 
манчестер: Манчестер Манчестере 
инсте: инсте 
приговор: приговоре приговор приговора 
обычно: обычно 
набрасывание: Набрасывание набрасывание 
флик: Флик Флика 
задуматься: задумаются задуматься 
обводка: обводок 
солнечный: солнечную 
гао: Гао 
парижский: парижский парижской 
бесследно: бесследно 
вылетать: вылетают вылетал 
расовый: расовой 
заслуга: заслугу заслуги 
российский: российские российской российском российским российскую российских российский российскому российская Российским российского Российской Российская российское 
заплатить: заплатил заплатила заплатили заплатит 
конференция: конференция конференций 
кричать: кричи кричат Кричать кричал кричали 
ахмат: Ахмата Ахмат 
пиво: пивом пиво 
опрос: Опрос опрос 
настать: настала настал 
джоэл: Джоэл 
субельдия: Субельдия 
мочь: мог можешь могло можем можете могут могли могла могу 
зато: Зато зато 
удача: Удачи удача удачи 
наш: наших Наша нашу наша Наш наши нашим нашего нашем нашей наш наше нашему 
пеп: Пеп 
удивляться: удивляются удивляется удивляюсь 
фейк: фейк 
палец: Палец пальцем палец пальцев пальца пальцами 
траур: трауре 
уэйн: Уэйн 
подробный: подробную Подробную Подробнее Подробная 
смочь: сможем Сможет сможет смогу смогла смогут смогли смог 
наркота: наркоту наркоты 
толком: толком 
сравнивать: сравнивать 
согласный: Согласен согласен 
карточка: карточку карточки 
матеуш: Матеуш 
турнирный: турнирной 
луч: лучами 
находить: находят 
встреча: встречам встреч встрече встречу встречи Встречу встреча Встреча встречах 
доехать: доедут 
начаться: Начнется начавшийся началось начнется 
тепло: тепла 
наркотик: наркотиками наркотиках наркотиков наркотики 
фармацевт: фармацевтов фармацевты 
геморройщиком: геморройщиком 
уверить: уверена уверены Уверена 
никто: Никто никого никто никому 
подло: подло 
наручник: наручники 
далековато: далековато 
переговоры: переговоры переговорах Переговоров переговоров 
оправдываеться: оправдываеться 
ла: Ла ла ЛА 
отдать: отдали отдаст отдал отдать 
подавать: подающий подавал 
выстраивать: выстраивают 
привыкнуть: привыкнуть привыкли 
рассмотреть: рассмотреть рассмотрел 
зимасегодня: зимасегодня 
деньга: деньгами денег деньгах Деньги деньги 
часик: часик 
начинать: Начинаю Начиная начинает начиная начинай начинать 
эдвардс: Эдвардс 
рег: рег 
казаться: Казалось кажется кажись казалось кажутся Кажется 
ромеро: Ромеро 
приходить: приходите приходит 
прекращать: прекращать 
красиво: Красиво красиво 
подтверждение: подтверждением подтверждения 
атака: атака атаки атаку атаке атак 
каталония: Каталонии 
вахда: Вахда 
штамп: штамп 
скульптура: скульптуру 
пнуть: пнул 
фоден: Фоден 
достигать: достигают достигает 
гореть: горел горит горели 
многое: Многое многое многом 
воскресение: воскресенью 
повести: Повел 
вырасти: выросли вырастет вырасти 
бить: бил бьет бить 
офсайд: Офсайды офсайды 
невзрачный: невзрачный невзрачное 
близкий: близок ближайшем близки ближе ближайшее ближайший близка Ближе ближайшего ближайших 
абха: Абха 
павлович: Павловича Павлович 
тик: тики 
кумир: кумирах кумир 
перемешивать: перемешивать 
извести: изведут 
хавсави: Хавсави 
делать: делает делай делали делал делаем делают делаешь делать 
норвежский: норвежский 
зенит: Зениту зениту Зените Зенита Зенит зените 
московский: Московский московское московских московский московского московской московская московскому 
картина: картина 
роонисегодня: Роонисегодня 
трансфер: трансферами трансфер трансферы трансфера трансферов трансферах трансфером 
баскетбол: баскетболе баскетбол Баскетбол 
хотеть: Хотите Хотел хочешь хотят хотим хочу Хотели хотели хочет хотел 
база: база базы базу 
шейх: шейхов шейхи шейха 
лимит: лимит лимиту 
дополнительный: дополнительных дополнительными дополнительного дополнительный дополнительная 
думать: думал думают Думаю Думаешь думаете Думаете думаю думает думать 
держать: держать держал державшую держали держит держим держат 
очевидный: очевиден очевидным очевидные очевидный 
егор: Егора Егор 
сильный: сильными сильное сильнейшему сильным сильнее сильнейший сильный сильная 
совершенствоваться: совершенствоваться 
мокнуть: МОК 
богатый: богатые богат богатая 
равный: равными равны равном равных равнее равное равен равные равного 
дания: Дании Дания 
противоречие: противоречие 
царь: Царь царей 
зп: зп 
папановсегодня: Папановсегодня 
отличаться: отличаются отличается отличались 
нравиться: нравится нравятся 
творить: Творит творить твори 
предшественник: предшественников 
предсезонку: предсезонку 
сен: Сен 
бюджет: бюджетом бюджетах 
который: которого Которые которых которому которыми который которую которое которые котором которым которая 
кругом: кругом 
км: км 
изоляция: изоляции 
ожидаться: Ожидается 
текст: тексте текст текста текстом 
пробить: пробит пробили пробил пробить 
предложить: Предложили предложил предложим предложили предложит 
нацелить: нацелены 
футбольный: футбольной футбольная футбольным футбольных футбольные футбольном футбольный 
некоторый: некоторыми 
просчитывать: просчитывать 
запретить: запретил запретили запретить запретят 
поведение: поведение поведения поведении поведением 
многочисленный: многочисленных 
санкт: Санкт 
инга: Инге 
вспоминать: вспоминаете вспоминают 
город: Город городов город городом города городе 
разумный: разумную разумные 
власть: власти властью 
алкогольный: алкогольной алкогольного 
немыслимо: немыслимо 
хименес: Хименес 
расистский: расистскими 
польза: пользу 
шашлык: шашлыках 
ликвидировать: ликвидировать 
гомель: Гомель 
порадовать: порадует 
другой: Другое Другим другими другую другие другое других другим другого другая другому 
мина: Мина 
выполнить: выполнит 
положительный: Положительный 
радость: радость 
рома: Ромой Рома 
учить: учить учат 
бобб: Бобб 
настолько: Настолько 
оставлять: оставлять оставляют 
смысл: смысл смысле смысла 
флу: Флу 
главный: главном Главные Главный главным главных главный Главная 
коровинвчера: Коровинвчера 
сюжет: Сюжеты 
лола: лол 
количество: количеству количестве количеством количество 
оставить: оставили оставил оставит оставить 
противник: противник противника Противником противнику 
томас: Томасу Томаса Томас Томасе 
забить: забила забил забив забить забьют забили забившие забьем 
играть: Играй Играл играли играешь играет играю ИГРАЮТ играют играющие играть играла играл играющих играй 
швейцария: Швейцарии 
вспыхнуть: вспыхнула 
спорить: Спорить спорить спорят 
сборная: сборная сборной Сборная сборную 
рай: Раю 
свой: свое свои своего СВОИХ своем свой Свое своими Свой своему своих 
боевой: боевую боевой боевого 
рауль: Рауля Рауль 
продление: продлении продление продлению 
перейти: перейти перешла перешел 
судить: судим Судя судили судить судя 
мизерный: мизерные 
оборона: обороны обороне оборону 
идеально: идеально 
кокос: кокоса 
интернасьонала: Интернасьонала 
кадис: Кадис 
пожертвовать: пожертвовал пожертвует 
различный: различным различных 
здоровье: здоровья 
подтвердить: подтвердил 
прошлое: прошлого прошлому прошлое прошлым 
искать: ищет Искать искать Ищем 
неприятный: неприятные неприятен 
михаил: Михаил 
понятие: понятие понятия 
требл: требл Требл 
строчка: строчку строчках строчке строчка 
проведение: проведения 
себастьян: Себастьян 
самарский: Самарская Самарский самарская 
залог: залогу залог 
ювентус: Ювентуса Ювентусом Ювентус Ювентусу 
подчеркнуть: подчеркнул 
набрать: набрал набравшие набрать набрала набрали набрав наберет набравший 
черта: черта черт 
многодетный: многодетный 
рубен: Рубен Рубена 
фанайди: Фанайди фанайди 
забиваться: забивается 
сыграть: сыграли сыграла сыграть сыграно сыграет сыграв сыграл сыграют 
стать: стал ставшем стать стала стали стало станет 
внести: внести 
поддерживать: поддерживает поддерживаю поддерживал поддерживают поддерживать 
дума: дума думу Думе 
выбирать: Выбирайте выбирал 
переход: перехода переходов переходе переход 
самоуничтожается: Самоуничтожается 
обижаться: обижается обижаться 
такой: Таким таким такая такого такими такое Такие Такому такие Такое таких такую таком такому 
вылететь: вылетит вылетели вылететь вылетел 
преимущество: Преимущество преимуществе преимущество преимуществом 
футболистка: футболистка Футболистка футболистки 
отказаться: отказался откажутся отказались отказаться 
вернуться: вернулся вернулась вернется вернуться 
босс: Боссы 
наполоть: Наполи 
прикол: приколу 
двойной: двойных Двойные 
высказаться: высказался высказалась высказаться 
клуб: клубе клуб клубом клубах клубу клубы Клуб клубами клубов Клубу клуба 
сарамутин: Сарамутин 
отметить: Отметим отметить отметим отметил отметила 
восьмой: восьмую 
балда: балды 
урал: Урал Урала 
триумфатор: триумфатора 
одобрить: одобрили одобрило одобрил 
следующий: следующими следующую следующая 
ситуация: ситуациях ситуацию Ситуацию ситуаций ситуация Ситуация ситуацией 
судьба: судьба Судьба судьбу 
итак: Итак 
добродушный: добродушный 
вциом: ВЦИОМ 
кинуться: кинулись 
майами: Майами 
знаменитый: знаменитых 
суметь: сумели сумеет сумел 
номер: номером номера номер номере 
отлетать: отлетала отлетал 
землянка: землянку 
прекрасно: Прекрасно прекрасно 
недостаток: недостаток недостатков 
техничный: техничен 
тестирование: тестирования 
грейф: Грейф 
служба: Служба службы Службы 
документальный: документальный 
эфир: эфире 
отмазать: отмазали отмазать 
сложность: сложностей сложность 
частый: чаще 
виссарионович: Виссарионович 
обходить: обходить обходят 
старый: старые старому старых старый Старый 
магальянес: Магальянес 
скатать: скатали скатал 
леверкузенцы: Леверкузенцы 
милан: Миланом Милана Милане Милану Милан 
докуда: Докуда докуда 
четвертьфиналистами: четвертьфиналистами 
тагиевсегодня: Тагиевсегодня 
фк: фк ФК 
вавро: Вавро 
райола: Райола 
маленький: маленький маленьких Маленький меньше Меньше маленькая поменьше 
барыга: Барыга 
отправитель: отправителя 
фарид: Фарид 
перекладывать: Перекладывать 
сметь: смеют смею 
пробка: пробка 
плохой: похуже плохое худших плохом плохие плохого хуже 
соврать: соврать 
уважать: уважают уважаем уважать 
неделя: неделе недель недели неделю 
блокировать: блокирует 
майкл: майклом Майкл 
доминирование: Доминирование доминирования 
введение: введения 
шесть: шесть шести 
васильевсегодня: Васильевсегодня 
гитара: гитаре Гитару 
преуспеть: преуспел 
тотенхэм: Тотенхэм 
эксперт: экспертов 
имя: имени именами имя именам имена именем 
чжу: Чжу 
реабилитация: реабилитация 
хотеться: хотелось Хотелось хочется Хочется 
трёхсотый: трехсотые 
испанец: испанца испанцев испанцем испанец 
рудковская: Рудковская 
цай: Цай 
последний: ПОСЛЕДНИЕ Последняя последнем последнего Последний последние последней последняя последнее последним последнюю Последние последний последних 
поголовно: поголовно 
усилиться: усилиться 
распрощаться: распрощаться 
утянуть: утянуть 
осуждать: осуждает осуждать осуждаю 
матеус: Матеус 
улететь: улетел 
доказать: доказать доказал доказали 
обсуждать: обсуждать обсуждаемые обсуждают 
юридическиго: юридическиго 
знать: знали знаю знает Знают знаешь знал знаете Знаешь зная знают Знаете знать знаем 
пища: пищу пища 
тренировка: тренировкам тренировками тренировке тренировок 
звать: зовут зовет 
рад: рад 
оборот: обороте 
подготовить: подготовил 
реально: реально Реально 
уверенно: уверенно 
гораздо: гораздо 
спартаковец: спартаковцев спартаковец 
девушка: девушкой Девушка девушками девушки девушка 
профессионализм: профессионализм профессионализма 
росс: Росс 
позиция: позицию позиций позиция позицией позициях 
брэдли: Брэдли 
означать: означает означать 
альмерия: Альмерия 
оправиться: оправиться оправился 
вес: веса 
похожий: похожая похожи похожих похож 
досрочно: досрочно 
предлагаться: предлагаются предлагается 
набалагурил: набалагурил 
неудача: неудачу неудачи неудач 
бундеслига: Бундеслига Бундеслиге бундеслига бундеслиге 
сожрать: сожрут 
крайний: крайнего крайнему Крайний 
сайт: сайтов сайт сайте сайты 
финт: финты финтов финта 
ожидать: ожидает ожидаешь ожидаемо Ожидаем ожидая ожидать ожидаю 
итальянский: итальянским итальянского Итальянская итальянских итальянскому итальянский 
арена: Арена Арене арены арене Арены 
островитянин: Островитян Островитяне островитян 
вырастать: вырастает 
взгляд: взгляд 
деревянный: деревянном 
отстать: отстав отстать 
пе: пе 
переборщить: переборщил 
перспективный: перспективные перспективнее перспективный перспективному перспективными 
пот: пот 
держаться: держался держаться держась держится 
завершить: завершил завершили завершит завершила 
май: мая 
лев: Леву Лев 
страна: страна стран стране страну Страна странами страны 
звезда: звезды звезда звездой звезд звезду 
современный: современный современных современной современную современном Современное 
растоптать: растоптав 
форвард: форварда форвард форвардами Форвард форвардов 
лера: Лерой 
менхенгладбаха: Менхенгладбаха 
минин: Минину 
галынскийвчера: Галынскийвчера 
поступок: поступках поступков 
ростов: Ростова Ростову 
завершиться: завершится завершился завершилось завершились 
влиться: влился 
уровень: уровне уровень уровня уровню 
джордж: Джорджа 
организация: организацию Организация организации организациям 
появиться: появилось появится Появились появиться появятся появилась 
федеральный: Федеральный федеральный федеральным 
дифирамб: дифирамбы 
лошадка: лошадку 
бобровсегодня: Бобровсегодня 
чёрный: черные черное 
компания: компании компания 
гол: голов голу гола Голами голами 
пас: пасы 
охранник: охранника 
больший: больший большая большее большую 
долфинс: Долфинс 
постить: постить 
удивить: удивить удивлены 
штанга: штанга штанг штангу штанги 
прогресс: прогрессом прогрессе Прогресс 
единственный: единственным единственный единственное Единственное 
отмазка: отмазки 
ноттингем: Ноттингем 
странниксегодня: странниксегодня 
пройти: пройдут прошло прошла пройдет прошли прошел пройти 
бах: Баха 
три: трех тремя 
подтверждать: подтверждаю Подтверждаю подтверждает 
отсидеть: отсидели ОТСИДЕЛИ отсидел 
являться: являются является являющийся 
иван: Иван 
трейлер: трейлер 
читать: читал читаешь читают Читайте читать читали 
проект: проекта проекте проект 
тенденция: тенденций тенденция 
приёмный: приемная 
верить: верят верит верить Верю верите верю верили 
оправдать: оправдана оправдать оправдан Оправдать 
спокойный: спокоен спокойный 
вильямиль: Вильямиль 
уничижительный: уничижительное 
обыграть: обыграли обыграла обыграть обыграл обыграет обыграв 
саутгейтом: Саутгейтом 
расизм: расизма расизмом 
перуанский: перуанский 
вариант: вариантов вариантом вариант варианты Вариант 
принять: примет приняли принял Примите принять примут принято 
сотрудница: сотрудницы 
втбнба: ВТБНБА 
обязательный: Обязательное обязательные 
выбить: выбил выбили 
тешить: тешить 
оказывать: оказывать 
господин: господину господин господа 
поединок: Поединок поединки поединке поединков поединках поединок поединка 
дмитриевсегодня: Дмитриевсегодня 
продолжить: продолжит продолжить продолжу 
работа: работе Работа работа работой работу работы 
красота: красота красоте красоту 
симпатизировать: симпатизировал симпатизирую 
бросаться: бросаться бросается 
посадить: посадит 
душа: души душе душа ДУША 
бедствовать: бедствую 
трудный: Трудная трудный трудные 
настоящий: настоящая настоящее настоящей настоящий Настоящий настоящие 
гандбол: Гандбол гандболе 
увы: увы 
анджелес: Анджелес Анджелеса 
усиление: усиления 
президент: президента президенту Президент Президента президент 
хавбек: хавбека Хавбеку Хавбек хавбек хавбеком 
уважение: уважении уважение Уважение 
молодёжный: молодежных молодежный 
джанлука: Джанлука Джанлуку 
средство: средств 
перерыв: перерыва перерывами перерывом перерыве 
выиграть: выиграть выиграл выиграна выиграли Выиграть выиграв выигравший выиграет выиграла 
гуннар: Гуннар 
полный: полным полный полном полное Полный полна полнейший 
выгодный: выгодная 
восстанавливаться: восстанавливаются восстанавливаться 
псих: псих 
австралия: Австралии Австралия Австралией 
считать: считают считаю считать считай считает считаете 
бекхэм: Бекхэма Бекхэм Бекхэмом 
безруков: Безруков 
правильный: правильные правильный 
рассказов: Рассказова 
эльюнусси: Эльюнусси 
фиорентиной: Фиорентиной 
выпустить: выпустит выпустили выпустят выпустить 
дотянуть: дотянули 
мюнхенский: мюнхенский мюнхенскую 
снежана: Снежана 
усвоить: усвоил 
тур: туров Туре туре тура турах туром 
зарядить: зарядить заряжены зарядил 
припомнить: припомнили припомню 
вить: вью 
антифутбол: антифутбол 
моур: Моур 
издеваться: издевался 
отклоняться: Отклоняются 
депутат: депутат депутаты Депутат депутата 
прокомментировать: прокомментирует прокомментировал 
азербайджанец: азербайджанцы азербайджанцев 
отправить: отправив отправлен отправил отправить Отправить 
опытный: опытные опытных опытнее опытнейшие опытным 
юношеский: юношеские 
логистический: логистическими 
айди: айди 
масии: Масии 
апрель: апреля 
опубликовать: Опубликовал опубликовав опубликовано опубликовал опубликовала 
волейбол: Волейбол 
геннадий: Геннадий 
тактика: тактика Тактика тактик тактику 
наказать: наказан Наказал наказал накажет 
каждый: каждого каждые каждом каждая Каждый каждую каждый каждым 
скандал: скандалах скандала скандалов 
матрасник: Матрасникам 
недавний: недавнего недавних 
нажить: нажил 
двое: двоих 
один: одних одно одна Одним одни Одну Одна одну Одно одному одним одними одном 
тренд: трендов 
способный: способно способны способен 
комментатор: комментатор комментаторы 
поговорить: поговорили 
луис: Луисом Луиса Луису Луис 
резко: резко 
красивый: красивая Красивые красивые 
расписание: Расписание расписание 
консолидация: консолидации 
интернациональный: интернациональная 
премия: премии премию премия 
выглядеть: Выглядят выглядит выглядели выглядела Выглядели выглядел 
понятный: понятные 
наносить: наносить наносят 
нападение: нападения нападение нападении 
иначе: иначе Иначе 
балтика: Балтике Балтика Балтику Балтикой 
длиться: длиться 
группа: группу группе группой группы группа 
синоптик: Синоптики синоптики 
пацан: пацана пацаны пацанов пацан 
герой: героя 
бутылка: бутылку 
нищий: нищим нищий нищих нищие 
прицел: прицелом 
сдесь: сдесь 
план: плане плану планах план планами 
арсенал: арсеналу Арсенал Арсенале Арсеналу Арсенала 
разбитый: разбит 
ориентироваться: ориентировались 
планировать: планирует планирующие 
полуэктов: Полуэктов 
курзенев: Курзенев 
любимчик: любимчика любимчик 
музыкасегодня: Музыкасегодня 
северный: Северная Северной 
преследоваться: преследуются 
ламли: Ламли 
филип: Филипа Филип 
сезон: сезоне сезонов сезон сезона Сезон сезонах сезоном сезону 
сделать: сделала сделали сделано сделай сделает сделаешь сделать сделал 
выпить: выпить 
уехать: уехал уехать уедет 
господь: Господи 
диктатор: диктаторов 
обмануть: обмануть 
рекомендовать: Рекомендованная Рекомендуемые рекомендую Рекомендуемая 
дэвис: Дэвиса Дэвис 
ощущение: ощущение 
рэпует: рэпует 
слух: слухам слухи 
армеец: армейцы армейцев армеец 
фнл: ФНЛ фнл 
илья: Илья 
давать: даем давал Давайте дают давать давали Давай дает давайте 
комплекс: комплекс 
обыгрывать: обыгрывая обыгрывать обыгрывает Обыгрывали обыгрывали 
невзирая: невзирая 
достижение: достижением достижение достижений достижения 
увести: увести увел 
дивизион: дивизион 
поддержка: поддержкой поддержки поддержка 
официальный: официальном официальные официальный официального официальных 
покупать: покупали покупать покупает 
рейтинг: рейтингах рейтинг рейтинге рейтинги 
попадание: попадания попаданием попадании попадание 
славий: Славию 
вовремя: вовремя 
стратосфера: стратосфере 
пить: пил пью 
трансляция: трансляция трансляцию трансляции 
джон: Джона Джон 
международный: Международные международный Международный международных Международных международные 
хенесс: Хенесс 
мнение: мнения мнение Мнение мнению мнением 
фон: фон фоне 
дубль: Дубль дублем дублю дубль дубли 
паук: паук 
предоставить: предоставил предоставить 
произойти: произошел произойдет произошла 
летний: летнее летним летнею летнего летний летнему 
прилететь: прилететь прилетит 
болельщиксегодня: болельщиксегодня 
безропотно: безропотно 
академия: академии 
дебютировать: дебютировал 
владимирсегодня: Владимирсегодня 
вопрос: Вопрос вопросов вопросу вопросы вопросом вопрос 
раздражать: раздражают 
лестница: лестнице 
хо: Хо 
взаимодействие: взаимодействия 
что: чему 
болеть: болеют болеть болею 
разочарование: разочарования 
гаскойн: Гаскойн 
мфл: МФЛ 
источник: источников источника источник Источник 
уволить: уволен уволили 
реал: реал Реалу Реал Реалом Реала Реале 
спарринг: спарринги 
дурачок: дурачок дурачки 
катар: Катара Катаре 
мысль: мысль 
покупка: покупке покупки 
роберто: Роберто 
оценить: Оцените оценила оценить оценил 
отрицать: отрицаю 
ехать: едешь едет 
оставаться: остается 
местный: Местный 
принцип: принципу принципа принципе Принципы 
область: области 
вызывать: вызывали вызывать вызывают вызывает 
подписать: подписали подписал подписан подписать подпишет 
шави: Шави 
повториться: повториться 
сообщение: сообщении Сообщение сообщений сообщению 
продаваться: продается продаются 
очный: очный очном 
айбазовсегодня: Айбазовсегодня 
проводить: проводить проводят проводили проводил проводит проводила 
вылет: вылетов вылет вылета 
привести: приведем приведшего привести привело привел 
хесус: Хесус 
ничья: ничью ничья Ничья 
зима: зимы зима зиме 
статический: статические 
шурыгину: шурыгину 
видича: Видича 
заканчивать: заканчивать заканчивала 
придумать: придумал придумать 
предложение: предложениями предложении предложениям предложений предложение предложениях 
бог: Боге Бог бог богам боже Бога богу 
сторона: стороне сторону стороны сторон стороной 
редкий: Редкое 
многообещающий: многообещающую 
лейпциг: Лейпцигу Лейпцигом Лейпциг 
мангаля: Мангаля 
гном: Гном 
владеть: владела владея 
мирлинда: Мирлинда 
варан: Варана 
отреагировать: отреагировал отреагировали 
подбежать: подбежал 
ульсан: Ульсан 
эрнандессегодня: Эрнандессегодня 
приличный: приличный приличная приличное приличных 
тренер: тренером тренеров тренера Тренеру Тренер тренер тренеры тренере 
грузин: грузину 
устраивать: устраивает 
уголовник: уголовника уголовник уголовники уголовнику 
галаррета: Галаррета 
виктор: Виктора Виктор 
записать: записал 
бюджетный: бюджетных 
лига: лиге лига лиг Лиги Лигу лигах Лигой Лиге Лига лиги 
остальной: остальные остальных остальное остального Остальные остальным остальном 
провоцирование: провоцированием 
псж: псж ПСЖ 
координировать: координированный 
обморок: обморок 
уведомление: уведомления уведомлений уведомление 
прессинг: прессинг прессинге прессингами 
организатор: организатором Организатор 
псв: ПСВ 
божий: Божьи 
весельчак: весельчаку 
уходить: уходить уходил уходит 
плав: плаву 
кристиан: Кристиан 
голландский: голландские голландский 
макар: Макара 
рим: Рима Риме Рим 
понять: поймете понять пойму понял поняли 
поддаться: поддался 
слуцкий: Слуцкого 
вильялибре: Вильялибре 
прямой: прямому прямая прямую прямое прямом 
коридор: коридора 
куарежма: Куарежма 
линия: Линию линию 
зафиксировать: зафиксирована зафиксировало 
бумага: бумага 
масси: Масси 
монегаск: монегаски монегаскам монегасков 
писать: пишет писал пишут пишу писали пишете пишите Пишите Писали пиши писать пишешь 
провал: провал провалом провалов Провал 
улыбка: улыбкой 
раскрываться: раскрываться 
кубок: Кубком кубке кубков Кубок Кубка Кубке кубок кубка кубки кубком 
занести: занесут занесли 
мирный: мирной 
небольшой: Небольшое небольших Небольшие небольшие небольшую 
гуглить: гуглить 
прежде: прежде 
пролазить: пролазит 
пробивать: пробивал 
забитый: забита забиты забитыми забито забит 
любой: любая любыми любом любого любые Любому любых любое любую 
опередить: опередив опередили опередить 
бохумом: Бохумом 
место: местом месту места место месте 
копмейнерса: Копмейнерса 
умный: умная умный умным 
фрибет: фрибет Фрибет 
канонир: канониров 
однозначно: однозначно 
дорогой: дорогих 
промсик: Промсик 
среда: среда среду 
нефутбольными: нефутбольными 
сделка: сделках Сделка сделка сделке 
последствие: последствиям последствиях 
габбия: Габбия 
перейру: Перейру 
возразить: возразить 
персона: персону 
выложить: выложат выложил выложить выложив 
невезение: невезение 
соотечественник: соотечественников соотечественник 
полно: полно 
нога: ноги ногу ноге ногой ногах нога ногами 
фланг: флангах фланг фланге 
хайнкес: Хайнкес 
петербургский: Петербургский 
клубный: Клубный 
поле: Поля полю поля 
легионер: легионер 
статистика: статистикой статистика Статистика статистику статистике 
аравия: Аравия 
сам: сама Сама Саму сами Само 
также: Также также 
отпустить: отпустив отпустят 
агрессивный: агрессивном агрессивного 
статус: статусу статус статусе 
выпасть: выпал 
пиковый: пиковый 
национальный: национальному национальном национальных национального национальную 
фетисовсегодня: Фетисовсегодня 
подбросить: подбросили 
плитка: плитки 
набить: набили 
невилл: Невилл 
мадурейра: Мадурейра 
проиграть: проиграл проиграли проиграв проиграть проиграешь Проиграли проиграет проиграют проиграла 
приниматься: принимаются принимается 
красный: красно красную красными 
целый: целая целый 
попытка: попытку попыткой попытке попытки 
надеяться: надеется надеяться Надеюсь надеюсь 
сутки: суток 
возраст: возраста возраст возрасте 
эдмундович: эдмундович 
аутсайдер: аутсайдеру аутсайдерами 
подвиг: подвиги подвигам 
глава: главе главам Глава глава 
спортивный: спортивных Спортивный спортивная спортивного спортивный 
владение: владения владении владение Владение 
балл: балла балл баллов 
федя: Федю Феде 
астана: Астана 
небывалый: небывалую 
оускарссон: Оускарссон 
вад: Вада 
фоткаться: фоткаться 
каникулы: каникул 
чилиец: чилиец чилийцев 
договорённость: договоренность 
южанин: Южане южане 
победа: победа Победы победу побед победам Победу победы победе Победа победой 
жёсткий: жесткая 
зона: зону зона зоне зоны 
удар: удар ударов удара Удары ударе удары ударами 
центр: центре центр центра 
беспокойство: беспокойства 
хватить: хватит хватить 
дос: дос 
отличие: отличии отличие 
выплатить: выплатит 
ловелла: Ловелла 
барс: Барсу барсы барса Барс Барсы Барса Барсе 
направление: направление 
инвестор: инвесторам 
иностранный: иностранных иностранного 
француз: французов француза Французы француз 
иц: иц 
весна: весне 
хуниор: Хуниор 
одерживать: одерживала одерживает 
ответ: ответов Ответ ответа ответ ответы ответу 
вдобавок: вдобавок 
стараться: стараюсь старается стараясь стараться 
петербург: Петербурга Петербург Петербурге 
топор: топором 
ваня: Ваня 
грязный: грязная 
игорьвчера: Игорьвчера 
дьокереш: Дьокереш 
поколение: поколение 
намекать: намекают 
адам: Адам 
рвать: рвет рвут 
назвать: назвал назвала назвать назовет назовут названы назван названа назвали 
завтра: завтра Завтра 
смех: смеха смех 
диас: Диас диаса 
полуфинал: полуфиналы полуфинал полуфинале Полуфинал полуфиналу 
быть: будете будь будем будучи Будем буду будут 
талант: талант таланту 
жертва: жертва жертву Жертвами 
называть: называя называют называет называл 
узнать: узнал узнаешь узнать 
мартинес: Мартинеса 
зальцбург: Зальцбург 
заключение: заключения 
уйти: Ушел ушли ушло ушла ушел уйти уйдет 
фиксация: фиксация 
спарта: Спартой Спарта 
возможный: возможные возможным возможных возможный возможном возможного возможна 
гегемон: гегемон Гегемону гегемона гегемону 
ключевой: ключевых ключевое 
отличиться: отличились отличился отличиться 
лидер: Лидеру лидеров лидера Лидер лидерами лидер лидеры лидером лидерах 
настроить: настроен настроил настроена 
острый: острые 
алькарас: Алькарас 
уголовка: уголовках 
трофей: трофеи трофей трофеев трофеем Трофеи трофею трофея 
проигрывать: проигрывая проигрывать проигрывает проигрывала проигрывали проигрывают 
недавно: недавно 
продлить: продлив продлит продлить продлила продлил 
переживать: переживают переживает 
доходить: доходила 
успех: успехами успехом успехов успеха успех Успех 
забивать: забивали забивал забивая забивала забивать забивают забивает забиваешь 
преступник: преступник преступнику преступником преступники преступника преступников преступникам 
государственный: Государственная государственные 
штутгарт: Штутгарта Штутгарт 
март: марте Март март марта 
замахнуться: замахнуться 
поменять: поменять поменяют 
марушич: Марушич 
реклама: Реклама 
приводить: Приводим 
новость: новостей новость Новости НОВОСТИ новости Новость 
вильярреала: Вильярреала 
дойти: дошли дошло дошел дойти 
сидеть: сидит сидите сидел сидят сидеть сидишь 
представлять: представлять представляю представляет представляете 
газон: газона газон 
стрелец: Стрельцов 
хозяин: хозяева хозяев хозяином Хозяева 
невероятный: невероятное 
сообщать: сообщает сообщают 
выезжать: выезжал 
победитель: Победителями победители победителем победителей победитель победителя 
второй: вторую вторым втором второму второго вторых 
спасать: спасает 
крест: Крестах 
выстроить: выстроить 
ведомость: ведомость ведомостью 
франческо: Франческо 
грань: грани грань 
запад: западе 
развиваться: развивалась 
гадить: гадит 
ясный: ясна ясен 
век: века 
лавочка: лавочке 
пловец: Пловец 
обязать: обязан обязаны 
любитель: любителей любители 
поздний: позднего 
формальность: формальность 
считаться: считается считался 
ставленник: ставленниками 
простой: Проще попроще проще 
невообразимый: невообразимый 
жаловаться: жаловаться 
привезти: привезут привез 
шинниквчера: Шинниквчера 
россиянин: Россияне россиянах россиян РОССИЯНИН 
арбитр: арбитрам арбитра арбитры арбитру арбитр 
гараж: гаражи гараж 
ая: ая 
тупо: тупо 
сербия: Сербией Сербия Сербию Сербии 
наказывать: наказывают наказывать наказывали 
увольнение: увольнение увольнения 
неуверенность: Неуверенность 
любовь: любовь любви 
клоппе: Клоппе 
повлиять: повлиял повлиять 
барьер: барьер 
спуститься: спустились 
счастие: счастью 
полиция: полиции полицию полицией 
алёшка: Алешка 
арокой: Арокой 
наиграть: наиграли наиграть 
кроссовок: кроссовки кроссовках 
сходиться: сходятся 
олимпийский: олимпийскому Олимпийских Олимпийского олимпийский 
чувство: чувства чувство 
список: Список списке список 
студент: студентам студенты 
гигант: гигантов 
ворота: воротам ворот воротами ворота воротах 
проголосовать: проголосуете проголосовать проголосовал проголосует Проголосую 
любить: любят любили люблю 
филипс: Филипса Филипс 
райса: Райса 
натяжка: натяжкой 
мать: матерью мать 
итог: Итогом Итог итоге итогу итогам 
заиграть: заиграет заиграли заиграл 
разобрать: разобранная 
потерять: потерял потеряв потеряно потеряют потерять 
сраный: сраному 
левинсегодня: Левинсегодня 
заслужить: заслужили 
жером: Жером 
пойти: пойти пойдет Пошла пошел Пошел 
венгерский: венгерская 
кордоба: Кордобы 
стойкович: Стойкович 
философ: Философов 
тренерский: тренерский тренерского тренерскую тренерские 
слить: Слили сольют 
мюнхенец: мюнхенцы Мюнхенцы мюнхенцам мюнхенцев 
овертайм: овертайме овертайм овертайма 
осторожный: осторожная 
спортсмен: спортсменов спортсмены спортсмен Спортсмены 
сцена: сцена сцене сцены сцену 
спартачей: спартачей 
выигрышь: выигрышь 
выздороветь: выздоровевший 
располагать: располагает Располагая 
украина: Украины Украине Украина 
бклка: Бклка 
примета: примету 
индивидуальный: индивидуальных индивидуальные индивидуальный 
игор: Игор 
законодательство: законодательство законодательства законодательству 
друг: другу друзей друг 
спасти: спасли спасти спасет спас 
грустно: Грустно 
камень: камень 
мальчик: мальчиков 
справляться: справляются справляется 
таблица: таблицы таблице Таблицы Таблица таблицах 
риск: риск риска 
донбасс: донбасс Донбасс 
провоцировать: провоцировал 
предлагать: предлагал предлагаешь предлагаем Предлагаем предлагает предлагают 
кузяев: Кузяев 
заниматься: занимается занимались Заниматься заниматься занимался 
мерзавец: мерзавца мерзавцу 
дух: духом дух духа духе 
спбсегодня: Спбсегодня 
дядя: Дядя дядя 
вывести: выведя вывел вывели 
оба: Обе обоих обоими обе обеих 
стриминговый: Стриминговый 
возглавить: возглавил возглавь возглавит возглавить 
помочь: помогло помочь помогу помог Помогите помогли поможет помогут 
известный: известен известный известная известны известного 
ассистент: ассистентов ассистент Ассистент 
европа: Европе Европу Европа Европой Европы 
абдельхамид: Абдельхамид 
смешной: смешная 
телефон: телефоне телефона телефон телефону 
париж: Париж Париже 
пять: Пять пять пяти пятью 
кто: кого кем Кого кому Кому 
отложить: отложили отложен 
назад: назад 
чемпионат: чемпионат чемпионатами Чемпионат Чемпионата чемпионата чемпионатов чемпионату чемпионатом Чемпионату Чемпионаты Чемпионате чемпионатах чемпионате 
поражение: поражений поражениям поражениях поражение поражения Поражений 
малый: малый 
отстранение: отстранении отстранение 
идиот: идиоты идиотов идиотами 
списать: списать 
касаться: касается касаются 
высоко: повыше высоко 
покориться: покорился 
раз: разу раза разы 
товарищеский: Товарищеская Товарищеских ТОВАРИЩЕСКИЕ товарищеские Товарищеский Товарищеские товарищеский товарищеских товарищеском 
обязательно: обязательно Обязательно 
руис: Руис 
прям: прям 
бадминтон: Бадминтон 
иттифак: Иттифак 
игровой: игровых игровое игрового игровом игровую игровым 
настаивать: настаивал 
учватов: Учватов 
ночью: ночью 
собственный: собственного собственные Собственный собственных 
перевод: переводы перевод перевода 
помеха: помеха 
римлянин: римлянам римляне Римляне римлян 
полагать: полагает 
хаять: хаяли 
формула: Формулу Формула 
оренбуржец: оренбуржцы 
представляться: представляется 
доминировать: доминировать 
спросить: спросили Спросили спросил 
тунец: тунца 
гакпои: Гакпои 
ночной: ночного ночном 
возобновление: возобновлению возобновления 
впервой: впервой 
знакомый: знакомые знакомый 
буква: буквы букве 
выдавать: выдает выдаем выдают выдавайте 
природа: природы 
участие: участию участия участие участием Участие участии 
строй: строю 
грамотный: грамотнее грамотную 
минутный: минутную минутный 
присоединиться: присоединился присоединились присоединилась присоединится 
антинародный: Антинародная 
швеция: Швеции 
петь: пели петь 
суперзвезда: суперзвезда суперзвезд 
террорист: террорист 
миленький: миленькую 
дог: Дог 
фрайбург: Фрайбург 
предел: пределах пределами пределе предел 
пара: пару паре пара пары 
покинуть: покинуть покинул покинули 
клем: Клем 
керр: Керр 
консерватор: консерваторов 
рекопе: Рекопе 
твёрдый: твердую 
отчёт: отчетов отчет 
окафор: Окафор 
позволить: позволило позволит позволили позволить 
мучиться: мучается 
железный: железный 
влиять: влияют влиять влияет 
хага: Хага 
журнал: журнал Журнале 
алаева: Алаева 
разобраться: разобрался разобраться 
кариока: Кариока Кариоке 
придумывать: придумывают 
отличный: отличным отличные отличный отличную 
биатлон: биатлону биатлон Биатлон 
десятилетний: десятилетний 
вступить: вступит 
пахасегодня: пахасегодня 
предположение: предположение 
развлекать: развлекал развлекает 
ге: Ге 
нехило: нехило 
медведев: Медведев Медведева 
коллектив: коллектив коллективов 
отец: отец отца 
вдоволь: вдоволь 
классно: Классно 
зарплата: зарплат зарплату зарплатами зарплата 
кабы: кабы 
принимать: принимали принимать принимает 
грубиян: грубияном 
скромный: скромнее скромное скромный скромные скромной 
амбиция: амбициями амбиций 
обойти: обойдет обошли 
португалия: Португалия Португалию Португалии португалия 
относиться: относится относились отношусь относящихся относитесь 
оправданный: оправданными 
технарь: технарей 
гойяно: Гойяно 
указать: указали Укажите указана указал указано Указал 
виноватый: виноват виновата 
следствие: следствие следствием Следствие 
произвести: произвел 
маркус: Маркуса 
стоять: стоял стоять стоят 
чемпион: чемпионов чемпионами Чемпиону Чемпион Чемпионов чемпиона чемпион Чемпионом чемпионом 
снять: сняли снимут снять снимет 
постер: постере постеров 
халл: Халлу 
спорт: спорт спорту спорте спорта Спорт 
анзор: Анзор 
выигрывать: выигрывали выигрывал выигрывать 
нидерланды: Нидерланды Нидерландов Нидерландах Нидерландами 
сидоровсегодня: Сидоровсегодня 
вспомнить: Вспомнить вспомнить вспомнил вспомню 
стронгесту: Стронгесту 
португалец: португалец португальцы португальца португальцев 
мама: мама маме 
шарить: Шарит шарит 
вытягивать: вытягивать 
связаться: связался 
знакомыйсегодня: Знакомыйсегодня 
звёздный: звездному Звездные звездных звездный 
несмотря: несмотря 
римский: Римская римская Римской 
судья: судье Судьи Судья судьи судью судья 
ван: ван Ван 
удаление: Удаление удалении Удаления удаления удаление 
система: система систему системе 
гнаться: гонится 
угол: угла углы 
нож: нож ножом 
джазавчера: Джазавчера 
зарубежный: зарубежных зарубежные 
поэтому: поэтому Поэтому 
закон: законы законом закон Закона закона закону 
красава: красава Красава 
горка: Горка 
аугсбург: Аугсбург 
негусто: Негусто 
купить: купить купят купив куплено куплены купите куплена купили Купили 
крыша: крыша крыши 
бэкона: Бэкона 
восходящий: восходящую 
проблемка: проблемка 
трубка: трубку 
реабилитироваться: реабилитироваться 
какой: какому Каким какого каком какое какую какие каких каким какими Какое 
синьли: Синьли 
оштрафовать: оштрафован 
сл: сл 
составлять: составлять составляют составляет составлял 
каталонец: каталонцев каталонцами 
принципиальный: Принципиальные принципиальному принципиальные 
пробиться: пробилась пробился 
владимирович: ВЛАДИМИРОВИЧ 
дед: деду 
кража: кража кражу 
дешам: Дешам 
пэн: Пэн 
ненормально: Ненормально ненормально 
ворочать: ворочать 
бывать: бывают Бывают бывает Бывает 
радиус: радиусе 
особенный: особеннее особенное 
продержаться: продержатся продержится 
одержать: одержано одержал одержали одержав одержала одержать одержит 
провериться: проверься 
сконцентрировать: сконцентрирован 
встряхнуть: встряхнули 
уильямс: Уильямса Уильямс 
стратег: стратега стратег 
кейну: Кейну 
александара: Александар 
претендент: претендентами претендентов претендентом претендентах 
зависеть: зависят зависит зависеть 
гигантский: гигантские гигантскую 
агрессивно: агрессивно 
недоброжелатель: недоброжелатели 
победный: Победная победную Победный победными победный победного 
забыть: Забыли забудут забыл забудь забыли 
отталкиваться: отталкиваясь отталкиваться 
далэй: Далэй 
снилс: снилс 
конференциисегодня: конференциисегодня 
приезжать: приезжал приезжают приезжай 
поиграть: поиграет поиграть 
измениться: изменились изменится измениться изменилась 
это: этим 
часть: частью часть частях 
кузя: Кузя 
видный: виднее 
странный: странного странная странные 
порядок: порядка порядке порядок 
любимый: любимую 
пытаться: пытаться пытался пытаются пытается пытаетесь 
парочка: парочку 
силва: Силва 
причина: Причина причину причинам причинах причиной причин причина причине 
аренда: аренду аренды аренде аренда 
продать: продать продали продав продай Продали 
стоить: стоила стоил стоило стоим стоили 
пока: Пока пока 
нанести: нанес нанеся 
отдельный: отдельная отдельных 
сей: сих 
тот: те тому тех Те та ту 
родный: родная Родный родном 
серый: серый серых 
перечислять: перечислять 
вердикт: вердикта вердикт 
оказаться: окажется оказался оказаться оказавшись оказались оказалось окажусь 
зимний: зимнего Зимние зимнюю зимние Зимнем зимних 
главнокомандующий: главнокомандующий 
наивно: наивно 
гонка: гонке гонка Гонки 
пф: пф 
свалиться: свалилась 
губа: губам 
справедливый: справедливые справедлив 
бескомпромиссность: бескомпромиссность 
жора: Жора 
молдавский: молдавский 
моторс: Моторс 
вячеслав: Вячеслав 
голова: головы голова головой голову голове 
ви: ви 
пкр: ПКР 
сменить: сменит сменить сменили 
вытворять: вытворяет вытворял 
шлак: шлак 
час: час часов часа 
этап: этап этапа этапе 
ренану: Ренану 
бешеный: бешеный 
юзефпольскийвчера: Юзефпольскийвчера 
менять: меняет меняем меняю менять 
очко: очка очков очко 
сдать: сдаст 
повестка: повестки 
задержать: задержан задержали Задержали 
старт: Старт старт старте старта 
ответный: ответные ответном ответного ответный ответная Ответный Ответные 
дискотека: дискотеке 
впечатление: Впечатление впечатление впечатлениями 
континент: континенте 
трижды: трижды 
эрлингом: Эрлингом 
проход: проходов прохода проход 
успешный: успешным успешны успешных успешный 
зазрение: зазрения 
хэма: Хэма 
воля: воле воли 
убирать: убираем убирает 
черепашка: черепашки черепашка 
мольде: Мольде 
освещать: освещают 
анна: Анна 
выдаться: выдались 
скопипастили: скопипастили 
форсировать: форсируют 
дикий: дикая дикое 
офигел: офигел 
компонент: компонентам 
нуньеса: нуньеса Нуньеса 
назначить: назначить назначив назначенное 
публика: публикой публику публике 
ужасно: ужасно 
центрфорвард: центрфорварда 
слегка: слегка 
торино: Торино 
парагвай: Парагвай 
отель: отеле 
демонстративно: демонстративно 
фашист: Фашисты 
первенство: первенстве первенства 
соцсеть: соцсети соцсетях 
мотивировочный: мотивировочную 
бейсбол: Бейсбол 
влипнуть: влип 
финалист: финалист 
удивиться: удивились удивлюсь удивишься 
куча: кучей кучу 
действовать: действующую действовать 
засечь: засекли 
унитаз: унитазов 
лишение: лишение 
обычный: Обычная обычного 
прощупать: прощупать 
улучшиться: улучшилась 
приехать: приедет приехали приехал 
арагонес: Арагонес 
трата: тратами тратах тратам трата 
стартовать: стартует 
троица: троицы троица 
доказательно: доказательно 
андрей: Андрею Андрей 
ффп: ФФП 
четвёрка: четверку 
малага: Малагу 
удаться: удался удастся удалось 
попытаться: попытавшийся попытаться 
разнос: Разнос разносом 
фактически: фактически 
эступиньян: Эступиньян 
категория: категория 
фаворит: фаворита Фаворит фаворитов фаворитом фаворит 
олимпизма: олимпизма 
разгильдяйский: разгильдяйским 
кампль: Кампль 
зарабатывать: зарабатывает зарабатывают 
полупустом: полупустом 
алиссона: Алиссона 
тео: Тео 
прекратить: прекратила прекратит Прекрати 
выгнать: Выгнать выгнали выгнан 
чемпмонат: чемпмонат 
матч: матчах Матчей матча матчи матчу матчам матче матч матчами матчем Матч Матчи матчей 
напомнить: Напомним напомню напомнит напомнил напомнить напомнишь 
фунт: фунтов 
завоевать: завоевал завоевать 
август: августе 
сорокин: Сорокин 
алло: алло 
перевес: перевесом перевеса 
правильно: правильно 
улыбаться: улыбается 
всемогущий: всемогущего 
мекка: Мекка 
опрокинуть: Опрокинул 
комиссия: комиссия комиссии 
эмоция: эмоций эмоциям 
чех: чехами 
бабич: Бабича Бабичу 
цифра: цифрами цифрой цифрах цифр 
борьба: Борьба борьбы борьбе борьба борьбу 
меньшинство: меньшинств 
труд: трудом труда 
оторваться: оторвался 
оставление: оставление 
глядеть: глядя глядишь Глядя 
эпизод: эпизод эпизоды эпизоде 
карабах: Карабах Карабаха Карабахом 
тяжкий: тягчайшее 
разгром: разгром разгрома 
сатирический: сатирическое 
справедливость: справедливость справедливости 
наркокартель: наркокартелей 
отдавать: Отдавать отдавать отдаю отдавали отдают 
статистический: статистические 
брозовича: Брозовича 
поэт: поэтов 
кон: кону 
торчать: торчали 
карабкаться: карабкается 
белград: Белграде 
подписание: Подписание подписанию подписание подписаниями подписанием подписании 
партия: партий 
фильм: фильм 
мощь: мощь мощью 
фортануло: фортануло 
скатиться: скатилась скатились 
наивный: наивный 
популизм: популизма популизмом популизм 
закончить: закончили закончишь закончат закончить 
весь: всему Всем весь всем Вся вся всеми 
солидный: солидные солидное солидную 
упоминать: упоминал 
еле: еле 
стареть: стареет 
упоминаться: упоминалось 
минуткакой: минуткакой 
финансирование: Финансирование 
вспышка: вспышки 
англичанин: англичане англичанам англичанами англичан англичанина 
трансферный: трансферную трансферный 
вколотить: вколотил 
география: географию 
баревчера: баревчера 
отсрочка: отсрочку 
адебайора: адебайора 
видеть: вижу видя видеть видит видят видел видели видим 
занавес: занавес 
зуб: зубы 
пятёрка: пятерку Пятерка пятерки 
идти: шла идет Идет шел шли идут идущего Идем идти 
злить: злит 
трусость: трусость 
выбытие: выбытия 
парижанин: парижане парижан Парижане 
чжо: Чжо 
майк: майка 
серия: серию серии серий Серию Серия Серии серия 
арест: арестом 
яйцо: яиц яйцами 
слушать: слушай слушать 
дек: Деку 
газпром: газпрома Газпрома газпром Газпром 
стрелять: стреляет 
мотивация: мотиваций мотивациях 
хина: Хин 
удивлённый: удивлен 
беспомощно: беспомощно 
этот: этими эта этих 
влияние: влияние влияния 
езда: езды 
петровсегодня: Петровсегодня 
лоди: Лоди 
тоттенхэм: Тоттенхэм 
отмечаться: отмечается Отмечается 
потрясать: потрясающие Потрясающая 
барселоненачинай: Барселоненачинай 
четыре: четырех четыре Четыре 
помощник: Помощник помощников помощник помощником 
информационный: информационные 
кертис: Кертис 
картахена: Картахена 
уверенность: уверенности уверенность 
перестать: перестал перестанут перестать перестала 
технический: Технический Технической 
миллер: Миллера 
гальесе: Гальесе 
подлый: подлее подлый 
зажигалка: зажигалкой 
эрнандес: Эрнандес 
десятизначную: десятизначную 
геополитический: геополитическая 
бабангидасегодня: Бабангидасегодня 
около: около ок ОК Около 
предполагать: предполагают предполагаемая 
работать: работают работает работал работать 
учитывать: Учитывая учитывать учитывая 
оказать: оказали 
конфликт: конфликт конфликта 
средний: Средней средними средний 
применяться: применяются 
пример: примеру Примеры пример 
несколько: несколько Несколько нескольких 
пол: Пола 
предсезонке: предсезонке 
изменение: изменений 
легенда: ЛЕГЕНДУ легенда Легендой легендой легенд легендами Легенда легенды 
помогать: помогает помогал помогать помогала 
бублик: бублика 
лёгкий: Легкая 
выпивка: выпивке 
отжать: отжали 
репрессивный: Репрессивные 
парень: парень Парень Парню парня парню парни парнем 
уля: Ули 
течение: течении течение 
милый: милейший 
родственник: родственников родственника 
лежать: лежит 
заматереть: заматереет 
вечный: вечный вечное 
совать: совал 
ознакомиться: ознакомиться Ознакомьтесь ознакомимся 
нигде: нигде Нигде 
срок: срок сроке 
торговать: торговать торговал 
собрать: собрать собрана 
белый: белым белый белом бело 
презика: презика 
персональный: Персональная 
рановато: рановато 
продавать: продают продавать 
вничью: вничью 
касание: касания касанием 
юбилейный: юбилейный 
млс: МЛС 
упустить: упустил упустили упустив 
наём: найма 
смеяться: смеяться 
большинство: большинстве 
аспиликуэта: Аспиликуэта 
хрень: хрень 
ямал: ямала 
вводить: вводят 
австрия: Австрия 
карлосасегодня: Карлосасегодня 
разыграть: разыгран разыграют 
оперуполномоченный: оперуполномоченный 
непростой: непростом 
сокровище: сокровище 
ударить: ударивший ударил ударить 
мамоноввчера: Мамоноввчера 
принести: принеся принесет принес 
сказать: сказал сказать сказали сказала сказанная скажет скажу скажите скажут 
результат: результатах результатами результатов результаты результат результатом Результаты 
тайм: тайма таймов таймах тайм тайму тайме 
дышать: Дыши 
накануне: Накануне накануне 
совет: Советов 
интерес: интерес Интересы интересах интересом 
активный: активнее активен 
докатить: докатить 
киллиана: Киллиана 
довод: доводах 
немецкий: немецким 
эквадорский: эквадорский 
спешить: спешат 
шериф: Шериф 
мы: Нам нам нами 
народ: народ 
западный: западная западные западном 
сломать: сломанные сломал сломать 
третий: Третий третьего третья третью третий третьих 
карьера: карьере карьеру Карьеры карьеры 
колея: колею 
изувечить: изувечила 
устать: устали 
организовать: организовать 
паралимпиец: паралимпийцев 
ионов: Ионовым 
кеф: кеф 
велосипед: велосипеде велосипед 
оторвать: оторвал 
реверанс: реверансов 
остаться: остались оставшихся оставшимся остался Осталось осталось останется остаться 
трафик: трафик 
плыть: плыви 
рассчитывать: рассчитывать рассчитывают рассчитывает рассчитывая 
опция: опцией 
беспринципный: беспринципные 
громкий: громче громким громкая 
чилийский: чилийский 
присутствовать: присутствовал присутствовать 
плюс: плюсом 
практиковать: практикует 
себастиан: Себастиан 
стадия: стадии стадия стадию 
платить: платить платят платил 
гость: гостей гости гостях 
аргентинский: аргентинский аргентинского аргентинскую 
приковать: приковало приковано 
трибуна: трибуны трибуну трибунами трибуне трибун 
изумительный: изумительные 
ласа: Лас 
попадать: попадают попадает попадала 
закрытый: закрытыми 
далёкий: дальше далеком 
хустисия: Хустисия 
сражаться: сражаться сражаются СРАЖАЮТСЯ 
вчера: Вчера вчера 
звание: звание званию 
мадридец: мадридцев мадридцы Мадридцы 
торг: торга 
раскрыть: раскрыть 
жестокий: жестокое 
пассивный: пассивен 
откликнуться: откликнуться 
рекорд: рекорду рекорд рекордов рекорды 
лёха: Леха Лехи 
незадолго: незадолго 
ес: ЕС 
возвращение: возвращении возвращение 
разорвать: разорвать 
факел: Факел Факеле 
би: Би 
отвечать: отвечать отвечал Отвечал 
следовать: следовало следовали Следует следует 
пересечься: пересеклись 
проклятие: проклятии 
вред: вреда 
невидимый: невидимыми 
нок: НОК 
безопасность: безопасности 
наркоторговец: наркоторговец НАРКОТОРГОВЕЦ 
доминик: Доминика 
бомбардир: бомбардиру бомбардиром бомбардир бомбардиров 
развитие: развития 
впервые: Впервые впервые 
путём: путем 
келлехером: Келлехером 
разгильдяй: разгильдяем разгильдяй 
заехать: заехал заехать 
путёвка: Путевку путевку 
вариативность: вариативность 
позор: позора Позор позор 
насильник: насильник 
бразилец: бразильцами бразильца бразилец бразильцы бразильцев 
отставка: отставка отставку отставки 
соответствие: соответствии 
кант: Канте 
форма: форму форме 
куинджисегодня: Куинджисегодня 
оппонент: оппонента оппоненты Оппоненты 
трое: трое 
показатель: показатель показатели показателей 
вася: Вася 
задавить: задавила задавят 
интересоваться: интересуешься интересуются интересуется интересовались 
вешать: вешали 
тушинский: тушинский 
рафаэль: Рафаэль 
трюк: трюки 
трудность: трудностями трудностям 
треть: трети 
трогать: трогать 
салех: Салех 
хет: хет 
адвинкула: Адвинкула 
браими: Браими 
точно: точно Точно 
эмоциональный: эмоциональным 
неудобный: неудобное 
бельгия: Бельгия 
ошбика: ошбика 
носить: носили 
мести: Мело 
причём: причем Причем 
бред: Бред бред 
ливерпуль: ЛИВЕРПУЛЯ ливерпуля Ливерпуля Ливерпуль Ливерпулем Ливерпулю Ливерпуле 
киммих: Киммих киммих 
бильярд: Бильярд 
сосед: соседу соседа соседи 
совершенствовать: совершенствовать 
радовать: радуют радует 
зараза: зараза 
эпоха: эпоху 
славия: Славией 
футболсегодня: Футболсегодня 
часто: Часто часто 
написать: написать написал напиши написанное Написали Написал напишу написана Написано написали 
букмекер: букмекеров букмекерами букмекера Букмекеры букмекеры 
политический: политический политическим 
ларин: Ларин 
комитет: комитета комитет Комитет 
превыше: превыше 
брайан: Брайан 
зацепка: зацепку 
середняк: середняка середняки середняках середняк середнякам 
слабохарактерность: слабохарактерность 
собрат: собрат СОБРАТА 
защита: защиты защите Защита защитой 
пробежать: пробежал 
чемпионский: чемпионские 
итдсегодня: итдсегодня 
ныть: ноют ныл 
топ: топом ТОП Топ топ топов топе топам 
бускетс: Бускетс 
протяжение: протяжении 
потенциально: потенциально 
умирать: умирает 
давно: давно Давно 
включая: включая 
добрый: добрый 
молиться: молится 
гулять: гуляет 
рылов: Рылов 
возить: возил 
депай: Депай 
дождаться: дождаться Дождитесь дождался 
рассказ: рассказы Рассказов 
регулярно: регулярно 
делиться: делись 
шупо: Шупо 
увенчаться: увенчалась 
скобка: скобках 
активно: активно 
мероприятие: мероприятии мероприятий 
спартаковский: спартаковский 
магический: магические 
булыкин: Булыкин 
подарить: подарила 
решить: решить решено решил 
шутка: шуткой шутку 
палмейрас: Палмейрас 
браганса: Браганса 
алекс: алекс Алекс 
данные: данных данным 
тд: тд 
отношение: отношениях отношением отношении отношений отношение 
сетка: сетки сетку сетка 
оспаривать: оспаривает оспариваю оспариваем 
надоесть: надоел надоели надоело Надоела 
шедевр: шедевр шедевры 
лейндерс: Лейндерс 
паралимпийский: паралимпийский 
складываться: складывается складываться 
шикарный: шикарный 
давление: давлением давления давление 
недовольный: недоволен 
крутиться: крутится 
ленинградский: ленинградских 
руководить: руководил 
бачи: Бачи 
отмечать: отмечают отмечать отмечает 
дважды: дважды 
кампания: кампании кампанию 
черников: Черников 
создать: создать созданная создана создали 
вверх: вверх Вверх 
сток: Сток 
регион: регионов регионы 
проводиться: проводится проводилась 
ливерпуляквадрупл: Ливерпуляквадрупл 
юг: Юга 
тысяча: тыща тысяч 
пробоина: пробоиной 
обвинять: обвинять обвиняют обвиняли 
нести: несет 
сак: Сака 
максимум: максимум 
оскорблять: оскорблял оскорбляли оскорблять 
сухой: сухими 
тм: ТМ 
исправиться: исправились исправиться 
мужик: мужик мужику мужиков 
отонне: Отонне 
эффектно: эффектно 
большой: побольше велик большое большого велика большому 
шакир: Шакир 
администрация: Администрацию 
элитный: элитный 
горожанин: горожан горожане горожанами горожанам 
совершить: совершил 
действие: действий 
повторять: повторять повторяйте повторяют 
фан: Фан фан 
тайна: тайне 
граница: границе границу 
проблема: проблемах проблема проблеме проблемами проблемой проблем проблему 
росси: Росси 
мартин: Мартина Мартин 
момент: моменты моменту момент моментов момента моментом 
розыгрыш: розыгрыше розыгрыша 
обещать: обещают обещал 
егоров: Егоров 
вентилятор: вентилятора вентилятор 
отправлять: Отправляйте 
вечером: вечером 
проявиться: проявится 
подрабатывать: подрабатывающий 
винисиусом: Винисиусом 
спортдир: спортдир 
испражняться: испражнялся 
изучать: изучает изучаешь изучали 
убыток: убыток убытка 
чужой: чужом 
александр: Александром Александр Александра 
прежний: прежнюю прежнему 
анатолий: Анатолий 
теодор: Теодор 
признать: признан признать признал признала 
гномыч: Гномыч 
кьезе: Кьезе 
жеребьёвка: жеребьевки жеребьевке жеребьевкой 
энергия: энергию 
выборка: выборка 
истина: Истина истины 
апл: апл Апл АПЛ 
напоказ: напоказ 
бахнуть: бахнул 
стивенс: Стивенс 
медиалиги: Медиалиги 
чисто: чисто 
побороться: поборется побороться 
сиро: Сиро 
турнир: турнира турнирах турнир турниров турниры турнирами турнире 
кайф: кайф кайфом 
подумать: подумаешь подумать 
дортмунд: Дортмунд Дортмунде 
паспортист: паспортистам 
марокканец: марокканец 
фанам: фанам 
самарец: самарцы Самарцы самарцам 
предпочтительный: предпочтительными 
верблюжий: верблюжий 
кэф: кэф 
чашечка: чашечку 
рвноправия: Рвноправия 
эталон: эталоном 
диктатура: диктатурой 
фронт: фронт фронта фронтам 
исполнить: исполнены исполнить 
голивецсегодня: Голивецсегодня 
фабиан: Фабиан 
газзу: Газзу 
отключить: отключил 
самоуверенно: самоуверенно 
справиться: справиться справится 
ответить: ответить Ответить ответил ответили 
гештальт: гештальт 
встречаться: встречались 
нос: носа носом 
преемник: преемник 
слава: слава Слава 
дырка: дырка 
нетерпение: нетерпением 
халидж: Халидж 
казанцы: Казанцы казанцы 
олимпиада: Олимпиаде Олимпиады Олимпиаду 
отчислить: отчислили 
психология: психологии 
нуль: нулю нули 
сложный: сложнее сложное 
баняц: Баняц 
ария: ария 
бинкссегодня: Бинкссегодня 
ныне: ныне 
порой: порой Порой 
государство: государств государства 
взыскать: взыскали 
смена: смену сменах смена 
почта: почтой 
продажа: продажу продаже продажи 
согласиться: Соглашусь соглашусь согласиться согласимся Согласитесь согласились 
самоуничтожаются: самоуничтожаются 
очень: очень Очень 
некого: некому 
затем: затем Затем 
приостановить: приостановило приостановлено 
выявиться: выявится 
запас: запаса запасе запас 
соответствовать: соответствует соответствующую 
путин: Путину путину Путин Путина ПУТИН 
личка: Личка личку 
оправдание: оправданий 
сразу: сразу Сразу 
неровный: неровным 
найти: нашел найдут найти 
дружба: дружбы Дружбы 
давить: давить давят 
яркий: ярче яркая яркими 
викинг: викинг 
гала: Гала Гал 
блестеть: блестит 
подношение: подношение 
грачевсегодня: Грачевсегодня 
уметь: умеет 
пограничный: пограничного 
туда: туда 
идея: идей 
выезд: выезд выезде 
промахнуться: промахнулся промахнулись 
будда: Будда 
забывать: забывайте забывай 
алексеев: Алексеев 
получаться: получается получаются 
опровергнуть: опроверг опровергнуть 
видать: Виданное 
пьянство: пьянства 
энфилде: энфилде Энфилде 
пользователь: пользователем пользователей пользователь 
блат: Блатов 
бьянконери: бьянконери 
крыло: Крылья крыльев 
домогательство: домогательствах 
уступать: уступает уступать уступала уступали 
дело: делу деле Дело делом дела делов делами дел дело делах 
завести: завели завести 
сомнительный: сомнительная сомнительные 
рассматривать: рассматривать 
располагаться: располагаются 
грозный: грозный 
финансовый: финансовые финансовой финансовых 
приятно: приятно 
характерный: Характерный характерны 
связать: связано связать связан 
мартышка: мартышка 
полено: поленьями поленьев поленья 
мопсика: мопсика 
саудовский: саудовской Саудовской саудовская Саудовская 
вист: висте 
уверенный: уверенную уверен уверенная Уверен 
надеть: наденут надеть 
достаться: досталась 
михаилсегодня: Михаилсегодня 
перебраться: перебравшийся 
дмитрий: Дмитрий 
анализ: анализа 
интерпол: Интерполу Интерполом Интерпол 
перевести: перевели перевел перевести 
сдеееелал: сдеееелал 
справка: справка 
управляющийсегодня: Управляющийсегодня 
китайский: китайской китайский 
торрес: Торрес 
айверсонавчера: Айверсонавчера 
предыдущий: предыдущих предыдущем 
тотровсегодня: Тотровсегодня 
странно: странно Странно 
провести: провел проведут провела проведет провели провести Провел 
обама: Обаму Обамой 
иванов: Иванов 
азимовсегодня: Азимовсегодня 
франция: Франции Франция 
скамакке: Скамакке 
отдельно: отдельно 
глаз: глазом глаза глазами 
пукнул: пукнул 
круг: круга круг 
расти: растет 
диалог: диалогами 
пребывать: пребывают 
влететь: влететь 
наличие: наличии наличие 
добавить: добавило добавленных добавит добавил добавить добавлена Добавить 
наблюдать: Наблюдая наблюдать наблюдают наблюдаем 
цена: цена ценой 
зарема: Зареме Зарема 
выпускать: выпускать 
рявкнуть: рявкнет 
подстраховка: подстраховкой 
готовность: готовность 
видеться: видится 
колено: колено колена коленом 
фантастический: фантастический Фантастическая 
учёт: учетом 
подкрепить: подкрепили подкрепленные 
доступность: доступности 
основный: Основная 
нестабильный: нестабильная 
серб: сербами сербов сербы серб серба 
риберисегодня: Риберисегодня 
дзагоева: Дзагоева 
заняться: заняться займется 
стрельба: Стрельба 
подряд: подряд 
контора: конторы контор контора 
вопреки: вопреки 
расстроиться: расстроились 
погребняк: Погребняк 
менеджмент: менеджмент 
холанда: Холанда 
реакция: реакцию реакции реакция 
несгибаемость: несгибаемость 
жаль: жаль 
бумажный: бумажное 
расследование: расследование Расследование расследования 
белорусский: белорусскому 
пьедестал: пьедестал 
хайбуловвчера: Хайбуловвчера 
руководство: руководству Руководству руководства Руководство руководство руководстве 
мельниковсегодня: Мельниковсегодня 
насра: Насра 
пауль: Пауль 
постепенно: постепенно 
сотрудник: сотруднику сотрудники 
гросс: Гросса 
утвердить: утвердил 
кстати: Кстати кстати 
британский: Британский британский 
затупить: затупил 
насколько: насколько 
буна: Буну 
навряд: навряд 
позавидовать: позавидуешь 
прилетать: прилетать 
проходить: проходил проходят проходит проходили проходить 
запомниться: запомнился 
вина: вину 
помешать: помешало 
общаться: общалась общался общались 
мадрид: Мадрида Мадриде Мадрид 
растяжка: растяжке 
нулевку: нулевку 
драндулетавчера: драндулетавчера 
масштаб: масштабах масштаба 
предупреждение: Предупреждения Предупреждение 
бразилия: Бразилия Бразилии бразилия 
медиафутболу: медиафутболу 
белоус: Белоус 
суп: суп 
зарешало: зарешало 
всякий: всякого всяких всякую всякий 
установить: установить установлено 
регулярный: регулярного регулярный 
пупкинсегодня: Пупкинсегодня 
контрабандист: контрабандисту 
трусливый: трусливый трусливую 
эквадор: Эквадоре Эквадор Эквадора 
передача: передача передач передачами передачу передачи передачей 
голевой: голевая Голевая голевые голевую 
унылый: унылые 
чарльз: Чарльз 
хлам: хлам 
детство: детства детстве 
стерлинг: Стерлинг 
разный: разными разных разным разные 
даниэл: Даниэл 
кампуш: Кампуш 
выкрикнуть: выкрикнул 
журналистика: журналистикам 
пресса: прессу прессе прессой прессы пресса 
потерпеть: потерпели потерпела потерпев потерпеть потерпел 
успешно: успешно 
информация: информацию информации информация 
сказываться: сказывается 
отменять: отменять 
обочина: обочине 
сок: Сок 
сектор: сектора 
перегибать: перегибали 
роналду: Роналду 
выход: выходе выходом выхода выход 
прочее: прочего 
пахать: пахать пахал 
эрик: Эрик Эрика 
гражданин: граждан гражданам гражданин гражданина 
подождать: подождать 
заявка: заявок заявке 
бк: БК 
ничто: ничто ничем 
этихад: Этихад 
фанат: фанаты Фанаты фанатах фанатов Фаната 
трент: трент Трент 
нужный: нужен нужна нужны 
выбор: выбора выбор 
неуважение: неуважение 
обзор: обзор 
расшифровываться: расшифровывается 
центральный: Центральном 
перелом: перелом 
недвусмысленно: недвусмысленно 
пригласить: пригласили 
огонь: огне огня 
выступить: выступил выступит 
условно: Условно 
родина: Родине родине Родина Родиной 
приглашать: приглашаем приглашаю 
фигурант: фигурантом 
мюнхен: Мюнхене Мюнхена 
пиняев: Пиняев 
убедить: Убедили убедить 
ограничиться: ограничатся 
типичный: типичных типичные 
инженер: Инженер 
скелетон: скелетон 
черногория: Черногории Черногория 
перформанс: перформанс 
неужели: неужели 
окончательный: Окончательное 
битва: Битва битва 
желаемый: желаемое 
бросить: бросит 
млрд: млрд 
нонж: Нонж 
лондонец: лондонцам 
безвыигрышная: Безвыигрышная 
точечный: точечно 
драфт: драфте 
общий: общих общему общий общая общую общей общем общего 
лезть: лезть 
везти: везли 
ноябрь: ноябре ноября 
приносить: приносящий приносить приносит приносил 
рождение: рождения рождению рождении 
непонятно: Непонятно непонятно 
удовольствие: удовольствие 
кутепов: Кутепов 
саманта: Саманта Саманту 
бегать: бегал бегали бегать 
санчиссегодня: Санчиссегодня 
мужчина: мужчина мужчин 
ощущать: ощущать 
престиж: престиж престижа 
кустурица: Кустурица 
манчестерский: Манчестерский 
фулхэм: Фулхэм 
нонсенс: нонсенс 
россия: Россией Россию России Россия 
жалко: Жалко жалко 
ледниковый: Ледниковый 
мартинс: Мартинс 
пожалуйста: пожалуйста 
готовый: готовых готова готов готовую готовым готовы 
задаватьну: задаватьну 
соглашаться: соглашаться соглашается 
рингтон: рингтоне 
полузащита: Полузащита полузащите 
ругаться: ругающийся 
гонсалес: Гонсалес 
ножевой: ножевая 
мораль: моралью 
привлекать: привлекать 
вылезти: вылезти 
клавиша: клавишу 
моракта: Моракта 
опережать: опережает опережая опережали 
простофиля: простофиля 
спрогрессировал: спрогрессировал 
дикс: Дикс 
человеческий: Человеческие 
должность: должностей 
выписать: выписали 
влезть: влез 
банкротство: банкротства банкротстве 
визит: визитом 
разумеется: разумеется 
финал: финала финале Финал финал финалы финалами 
брайтон: Брайтону Брайтоном Брайтон Брайтоне Брайтона 
наброс: наброс 
осудить: осужденному осудил 
минь: Мини мини 
поступать: поступал 
авторитет: Авторитет авторитет 
разгромить: разгромила разгромили разгромить 
диван: диван дивана диване диванам 
медиафутбола: медиафутбола 
бургер: Бургера 
бразильский: бразильскими бразильский бразильском 
алкан: алканов 
списывать: списывать 
сотворить: сотворил 
распространить: Распространенный 
грустный: грустный грустным 
льюис: Льюис 
посадка: посадку 
опричнина: Опричнина 
подкат: подкате 
линекер: Линекер 
пэлас: Пэлас 
тащить: тащили тащит 
сан: Сан 
дискриминационный: дискриминационное 
допускать: допускать допускает 
опыт: опыту Опыт опыт опыте 
довольный: довольны доволен 
полезный: полезную полезных 
кратный: кратный 
хотя: Хотя хотя 
выражать: выражает 
меняться: меняются менялся 
фора: фора форой 
никита: Никита 
пароль: пароль 
выбивать: выбивал выбивающие 
йочич: Йочич 
растаптывать: растаптывать 
коротко: коротко 
стопроцентный: стопроцентный 
оливер: оливером Оливера 
выпадать: выпадал 
задержание: задержания 
путешествие: путешествиями 
основное: основном 
отпраздновать: отпраздновал 
остановка: остановке 
легализация: легализация 
торт: торте торта торт 
поленница: поленнице 
университетский: Университетская 
мозг: мозг мозгов мозги 
обладать: обладает обладают 
очередной: очередным очередная очередную очередное 
каршеринга: каршеринга 
бензема: Бензема 
том: Тома 
фамилия: фамилию 
обжаловать: обжаловать обжалует 
перестановка: перестановки перестановок 
снижение: снижения 
инстаграм: инстаграме 
рынок: рынка рынок рынком 
окленд: Окленд 
жена: жен жену жена 
вытаскивать: вытаскивая 
рост: Роста роста 
лидировать: лидировать лидирует лидируют 
австралийский: австралийским Австралийскую Австралийская 
ревнитель: ревнители 
конечный: конечном 
раздача: раздачу 
захаров: Захаров 
юмор: юмор 
достоевский: Достоевский 
семизначную: семизначную 
рио: Рио 
заслать: засланный 
космический: космический 
спонсор: спонсоров спонсоры 
бесспорный: бесспорный 
цирк: цирка 
побить: побить побил 
недооценить: недооцененный 
забавлять: забавляют 
желание: желания желании желание желанием Желание 
кхл: КХЛ 
улыбнуться: улыбнулась 
алексеевсегодня: Алексеевсегодня 
состояние: Состояние состоянии состояние 
символизировать: символизирующий 
отблагодарить: отблагодарит 
лидс: Лидс Лидсу Лидса Лидсом 
захотеть: захочет Захочет захотят 
отстранить: отстранить отстранили Отстранили 
вальтер: Вальтер 
курс: курсе 
ом: Ом 
отозваться: отозвался 
демон: демоны 
золотуха: золотуха 
травма: травма травму травмы травм 
эмир: Эмир 
автозаводец: автозаводцы 
крайность: крайность 
закадровый: Закадровый 
десятилетие: десятилетие десятилетия 
лэмпард: Лэмпард 
выходить: выходить выходили выходя выходил выходят выходило выходила Выходит 
повредить: повредил 
ощутить: ощутить 
тов: тов 
катастрофа: катастрофа катастрофой 
завод: заводу 
остудить: остудить 
размер: размере 
сентябрь: сентября сентябре сентябрю 
приоритетный: приоритетным 
победить: победив победила победят победить победим победил победили победит 
массовость: массовость 
мерседес: Мерседес 
рука: руками рукам руки руку Руки 
появление: появления появлении 
сильно: сильно 
бесплатно: бесплатно 
никакой: Никакого Никаких Никакой никакой никакие никакого никаких 
преступление: преступлениях преступление преступления 
овация: овацию 
увеличить: увеличил 
прийти: придет пришел прийти 
брага: Брагой Брага 
курбанова: Курбанова 
медиафутболе: медиафутболе 
язык: языки Языком 
боруссией: Боруссией 
гус: Гус 
оступиться: оступился оступятся 
нефтчи: Нефтчи 
утонуть: утонул 
реалия: реалиях 
обработать: обработал 
представить: представить представьте 
макать: Макая 
сосьедад: Сосьедад сосьедад 
прозвучать: прозвучит 
хромать: хромает 
покуражиться: покуражились 
гитарист: гитаристу 
взорвать: взорвал 
бандитский: бандитский 
снятой: снято 
автор: автор Автором 
порыв: порыве 
сегодня: сегодня Сегодня 
венгрия: Венгрия Венгрии 
минута: минуте минут минуту минутах минуты 
удержать: удержать 
вода: воды 
несопоставимый: несопоставимы 
получиться: получился получилось 
войти: вошла войдет Войти вошли 
ляля: ляля 
слать: шлешь 
барселонесегодня: Барселонесегодня 
деятельность: деятельности 
пена: пеной 
молодой: молодыми молодые молодых 
зрение: зрения 
набирать: набирает набирала набираете 
точность: точности 
контент: контент контента 
заказывать: заказываешь 
понятно: понятно Понятно 
предъявить: предъявлены предъявлено 
наказание: наказания наказание 
чс: ЧС 
локализовать: локализована 
точка: точке точки 
продолжение: продолжение продолжению продолжения 
робертсон: Робертсон 
представитель: Представители представитель представители представителей представителем 
снисходительный: снисходительны 
инфраструктура: инфраструктуры 
южный: Южной южном Южная Южный южному 
пауза: паузу паузой паузы Пауза 
стэйт: Стэйт 
чемпионшип: Чемпионшип 
оз: ОЗ 
совершенно: совершенно 
неплохо: неплохо 
удовлетворение: удовлетворения 
отметиться: отметился отметились 
вложить: вложил вложить 
максим: Максим 
покерфейсом: покерфейсом 
жирков: Жирков 
общественность: общественности 
простить: простили простить Простила 
посметь: посмел посмели 
модератор: модератором 
пожелать: пожелал пожелать 
са: СА Са 
рада: Рада рады 
случиться: случится случилось случилась случился Случилось 
убогий: убогий 
превращаться: превращается 
посетить: посетить 
читатьэтот: читатьэтот 
пелагея: Пелагея 
жюст: Жюст 
самопожертвование: самопожертвование 
находка: находка 
семья: семьи семьей Семье 
продолжительный: продолжительные 
выставить: выставить выставлен выставит 
саудовец: саудовец 
нейтральный: нейтральном нейтральных 
сместить: смести 
алан: Аланом Алан 
копейка: копейки 
терять: теряет теряли терять 
вышеперечисленный: вышеперечисленное 
застрять: застрял застрять 
неоправданный: неоправданный 
реагировать: реагировал 
клоппа: Клоппа 
голландец: Голландец голландец голландцев 
обвинение: обвинение Обвинение 
схема: схема схеме схемы схемами схему 
дель: дель Дель 
именитый: именитый 
жеглов: Жеглов 
инсайд: инсайды инсайд 
дремать: дремлют 
фигурный: Фигурное 
ангисса: Ангисса 
пулишич: Пулишич 
опасаться: опасаюсь опасаться 
роль: роль роли 
позволять: позволяют позволяет позволяющую 
господство: господстве 
суть: сути 
исключение: исключения исключении 
бердыев: Бердыев 
специальный: специальным Специальные специальных 
влута: Влута 
голландия: Голландии 
побеждать: побеждает побеждал побеждать побеждали 
рубин: Рубином 
раскольниковсегодня: Раскольниковсегодня 
ритм: ритме ритму 
дерьмо: дерьмом 
задача: задача задачу задач Задача 
право: праву право Права правах права прав 
следить: следит следил следить следят следи 
поздравление: поздравление 
расступаться: расступаться 
пускать: пускает пускал пускать 
выздоровление: Выздоровление 
дворянство: дворянство 
плечо: плечо 
фехтование: Фехтование 
ажно: ажно 
сенсация: сенсаций сенсациям сенсацией 
командный: командный командные 
вписать: впишут 
скорее: скорее Скорее 
девять: девяти Девять девять 
рама: раме 
чудик: чудику 
джульетта: Джульетта 
объявить: объявят объявила объявлено объявил 
антифашизм: Антифашизм 
мягкий: мягкие 
обеспечить: обеспечит 
расторгнуть: расторгнут расторгнуть 
варса: Варса 
состояться: состоялось состоялся состоится Состоялся состоялись 
адаптироваться: адаптируется адаптируются 
бин: бин Бин 
неадекват: неадекват 
река: реке 
могила: могилу 
молодец: молодцы молодец 
напрочь: напрочь 
назначать: назначать 
неважно: неважно 
полезть: полез 
сходить: сходить Сходи 
погрешность: погрешностей 
соболев: Соболев 
чистота: чистоты 
стиль: стиле стиля Стиль стиль стилем 
известно: известно 
оффать: оффать 
логически: логически 
предпочтение: предпочтениям предпочтениях 
миллион: миллион миллионами миллионы миллионов 
рисковать: рискует 
собираться: собираюсь собирается собираются СОБИРАЛСЯ собирался 
департамент: департаментов 
прокатить: прокатило 
олимпий: Олимпию 
забрать: забрал 
изобразить: изображены 
соотвественно: соотвественно 
аудакс: Аудакс 
назначение: назначению Назначение назначение назначения 
усилить: усилили усилить 
каннабис: каннабисом 
стереть: стер 
задавать: задаешь 
лутченковчера: Лутченковчера 
раса: расе 
погода: погоду 
высокий: высший высочайшая высоком высшая высокие высшей высокое высокими 
строительство: строительство 
поведать: Поведаем 
состав: состав состава составе составом Состав составы 
потенциал: Потенциал потенциал 
контейнер: контейнера 
беллингему: Беллингему 
артиллерия: артиллерии 
обсудить: обсудит 
правоохранительный: Правоохранительные 
белка: белку 
муса: Муса 
преодолеть: преодолеет 
отбыть: Отбудет 
ради: ради Ради 
ненаховсегодня: Ненаховсегодня 
воспользоваться: воспользуюсь воспользоваться 
створ: створ 
полтора: полторы 
знание: знания 
перестроить: перестроить 
смотреться: смотрелись смотрелся смотрится смотрелась смотрятся 
бромантановсегодня: Бромантановсегодня 
заставить: заставило заставить заставили заставил заставит 
нулевой: Нулевая Нулевые 
тая: Тае 
вовсе: вовсе 
андердогом: андердогом 
сульшер: Сульшер сульшер 
реальный: реальные реальный 
изнасилование: изнасиловании изнасилование 
дч: ДЧ 
бица: бица 
скамейка: скамейки скамейке 
хайпа: хайпа 
будущий: будущий 
среди: Среди среди 
идеальный: идеальный идеального идеальные 
проверять: проверять 
привлекательный: привлекательные 
осмыслить: осмысленную 
рестарт: рестарта Рестарт 
тюрьма: тюрьма тюрьмы тюрьме 
зелёный: зеленых зеленые 
марихуана: марихуану марихуаной 
голам: голам 
мешок: мешок мешки 
построить: построили построить 
болельщик: Болельщики болельщиков болельщикам Болельщиков Болельщикам болельщик болельщики 
надпись: надпись 
белок: белка 
гранада: Гранада 
хлопнуть: хлопнуть 
правый: правый 
ман: Ман ман 
окружение: окружением окружении 
коллаж: коллаже коллаж 
бедный: Бедный бедную 
исход: исходов исход исходом исходах 
исключать: исключает исключать 
предоставление: предоставления 
отнестись: отнеслись 
фильтр: фильтры 
потратить: потратили потратил потратить Потратили 
карман: кармане кармана 
лукойл: Лукойл 
гутинвчера: Гутинвчера 
спортинга: Спортинга 
бельгиец: бельгиец 
мемфис: Мемфис 
монстр: монстр 
кирьяк: Кирьяков 
игнорировать: игнорировал 
печальный: печальные 
готовиться: готовятся готовится готовитесь 
приём: приема приемом 
заработать: заработали заработать 
ши: Ши 
таков: такова таковы 
приставка: приставкой 
бессильный: бессилен 
травматов: травматов 
шанхай: Шанхай 
высказываться: высказываться 
прорвать: прорвать 
звонить: звонила 
цель: цель целях Цель целей 
горсовет: горсовета 
мой: мою мои моему 
условие: условия условий условие условиях 
мадридистами: мадридистами 
чертовский: чертовский 
себя: собой 
роналдусегодня: Роналдусегодня 
потолок: потолок 
продлиться: продлится 
изречение: изречениях 
фартануло: фартануло 
прецедент: прецедента 
помощь: помощью помощь 
долг: долги 
оттуда: оттуда 
противоречить: противоречите 
прочитать: Прочитай прочитанное Прочитайте 
хазем: Хазем 
оздоровление: оздоровлении 
наломать: наломал 
переложить: переложить 
владимир: Владимира ВЛАДИМИР Владимир 
расшифровать: Расшифрую 
альтернативный: альтернативные 
вручную: вручную 
говорить: говорит говорили Говорить говоря Говорили говорим говорить говорила говоришь говорят говорило говорю говорил 
прозреть: прозрели 
зависимость: зависимостью зависимость 
аналитик: Аналитики аналитиками аналитики 
дрогба: Дрогба 
рулить: рулит 
дзержинск: Дзержинск Дзержинска 
спустить: спустил 
материальный: материальных материальном 
грубый: грубейшую грубейшая 
чжи: Чжи 
начало: начале начала 
число: числе числу числа 
ойеда: Ойеда 
ряд: ряд 
важность: важностью важности 
офицер: офицера 
влюбляться: влюбляются 
весенний: весенний весеннюю весенними 
сумма: суммы сумме сумму сумма 
месяц: месяцев месяц месяца 
отдых: отдых 
аккаунт: аккаунте 
просмотр: просмотр просмотра просмотре 
из: изо 
карл: Карл 
медный: Медный медные 
заявление: заявления заявление Заявления 
эффективный: эффективном 
приказ: приказы 
суперлига: Суперлиге 
стоимость: стоимость стоимостью 
сложно: сложно Сложно 
женский: женском женский 
адекватно: адекватно 
стереотип: стереотипы 
вероятно: вероятно Вероятно 
запихнуть: запихнуть 
независимо: независимо 
внутренний: внутренние 
ранний: раньше Раньше ранних 
дмитриеввчера: Дмитриеввчера 
завершение: завершение завершения 
пимент: Пимента 
закрыть: закрыли закроют закрыл 
удивлять: удивляет Удивляют 
кьеза: Кьеза 
зрелый: зрелую зрелым 
отрезок: отрезок отрезка 
благодаря: благодаря Благодаря 
создавать: создаем создавали создает создают 
удалённый: удален 
упасть: упали 
рэпер: рэпера 
велитоном: Велитоном 
возмущаться: возмущались 
опьянение: опьянения 
кандидат: кандидаты кандидатов 
пункт: пункт пункта пункты 
сдаться: Сдамся сдамся 
запрос: запрос запросов 
заменять: заменял 
зарегистрироваться: Зарегистрироваться 
исследование: исследовании 
фифа: ФИФА фифы фифе 
дисквалификация: дисквалификация дисквалификацию 
ньюкасл: Ньюкаслом Ньюкасл Ньюкасла 
генеральный: генеральный 
сожаление: сожалению 
психолог: психолога 
честь: честь 
рассказывать: рассказывать рассказывал Рассказывая 
увидеть: увидели увидел Увидим увидят увидим увидеть 
удивительный: удивительного 
показывать: показывают показывая показывал показывать показывает показывали 
понт: понтов 
разговор: разговору разговор разговоров разговоры 
холанду: Холанду 
мем: мем 
оттмар: Оттмар 
обалдеть: обалдеть 
словно: словно 
призывать: призываю 
остановить: остановить 
данный: данном 
субъективный: субъективное 
убедительно: убедительно 
двор: двору дворе двора 
богач: богачам богачи 
уподобляться: уподобляться 
напористый: напористее 
волна: волне волна 
стэдиум: Стэдиум 
золотой: золотая Золотого золотого 
популярный: популярные популярным популярных 
пентуплах: пентуплах 
бавария: Баварию Баварией бавария Баварии Бавария 
нюанс: нюанс 
мукиеле: Мукиеле 
подвал: подвале 
обводить: обводили 
участник: участников участники 
гемморойщик: гемморойщик 
тусил: тусил 
наградить: награжден 
классика: классика 
длительность: длительностью 
отправиться: отправился 
зарегистрировать: зарегистрированы 
трудно: трудно 
еврокубком: Еврокубком 
подробно: Подробно 
траоре: Траоре 
мониторил: мониторил 
каталонский: каталонскому 
иттихад: Иттихад 
мол: мол 
даниил: Даниил 
прожить: прожил 
газза: Газза 
отлично: отлично 
медицинский: медицинских 
семь: семи семь 
летучий: летучих 
оплата: оплаты оплате 
отрыв: отрывом 
системный: системным 
столица: столице 
славно: славно 
неликвид: неликвид 
фахда: Фахда 
головной: головная 
упорный: упорном упорная 
виновный: виновен 
везение: везением везение 
скорость: скоростях скорость 
посредине: посредине 
завидовать: завидовать 
лечить: лечишь 
правило: правилу ПРАВИЛО правил Правило правило правилах 
серветт: Серветт 
фраза: фраза фразами 
завязать: завяжет 
самокат: Самокат 
краткосрочный: краткосрочном 
довести: довести 
засыпать: засыпают 
романовсегодня: Романовсегодня 
рекордсмен: рекордсмен 
прервать: прервать прервал 
потолкаться: Потолкались 
лондон: Лондона Лондоне 
краса: красе 
паспорт: паспорт Паспорт паспорта паспорту 
очочко: очочко 
бласвих: Бласвих 
глупый: глупы 
терпеть: терпит терпеть 
личность: личности 
далеко: Далеко далеко 
пользовательский: пользовательские Пользовательская 
площадь: площади 
запомнить: Запомнить запомнили 
кокорин: Кокорин 
камидзима: Камидзима 
нерв: нервов нервы 
демонстрировать: демонстрирует 
ржать: ржали ржал 
надежда: надеждам Надежда надежда 
кошелёк: кошельком 
саутгемптон: Саутгемптоном Саутгемптон Саутгемптона 
выдача: выдачи выдаче 
дисквалифицировать: дисквалифицировал дисквалифицирован дисквалифицировали 
мохамед: Мохамеда Мохамед 
например: Например например 
четвертьфинал: четвертьфиналов четвертьфинала четвертьфинале четвертьфинал 
кинопоиск: Кинопоиск 
гулачи: Гулачи 
аэаэах: аэаэах 
посол: Посол послом 
роберт: Роберт Роберта 
публиковать: публиковать 
неоднократно: неоднократно 
домингес: Домингес 
вместе: вместе 
бедро: бедра 
солт: Солт 
мендеш: Мендеш 
необходимо: необходимо 
воспринимать: воспринимаем 
зрелище: зрелище 
холланду: Холланду 
югославия: Югославия 
ранджелович: Ранджелович 
кевин: Кевин Кевина 
фейеноордом: Фейеноордом 
окенфэйловсегодня: Окенфэйловсегодня 
супертоп: супертоп 
натворить: натворит 
самозавода: самозавода 
туринец: туринцы туринцев 
неважный: неважные 
невзрачно: невзрачно 
чилить: чилить 
помимо: Помимо помимо 
вознаградить: вознаграждены 
взбодриться: взбодрись 
петарда: петарду 
энгельгардтсегодня: Энгельгардтсегодня 
пересмотреть: пересмотреть 
удобный: удобные удобным 
муссироваться: муссируются 
примерный: примерное 
низко: низко 
десять: десяти десять 
поклонник: поклонники поклонников поклонник 
петербургскийсегодня: Петербургскийсегодня 
комментировать: комментировать комментирует Комментировать 
ошибаться: ошибаются ошибаюсь 
греция: Греции 
колосковый: Колосков 
свобода: свобода Свобода свободы 
криминалитивчера: криминалитивчера 
одиночка: одиночку 
поднять: поднять подняли поднятую 
привыкать: привыкать Привыкать 
традиция: традиций традиция традициях 
к: Ко ко 
поскольку: Поскольку поскольку 
налаживать: налаживают 
вильям: Вильям 
крушение: Крушение 
поехать: поехала поехать поедут 
дерево: деревом 
кошт: Кошта 
сведение: сведений 
насчёт: насчет 
еремякин: Еремякин 
подзаработать: подзаработать 
ин: Ин 
джедай: джедаем 
жезус: Жезус 
нуньес: Нуньес 
прельстить: прельстил 
климов: Климову 
окр: ОКР 
спортингу: Спортингу 
упомянуть: упомянув 
повышение: повышением 
бубновасегодня: Бубновасегодня 
косорук: Косоруков 
теория: теории 
концовка: концовке 
хайнц: Хайнц 
степановсегодня: Степановсегодня 
подержать: подержит 
отыграться: отыгрались отыграться 
заносить: заносят 
пешком: пешком 
улыбнуло: улыбнуло 
научить: научит 
ноль: ноль 
бриллиант: бриллиантам 
американец: американцы 
групповой: групповом группового 
пс: ПС 
музыка: музыке музыки музыка 
кой: коем кое 
пополнить: пополнил 
неуважительный: неуважительное 
соревнование: соревнованиям 
маура: Маура 
примечательно: Примечательно 
испания: Испания Испанией Испании 
александровичсегодня: Александровичсегодня 
слабый: послабее слабый 
антуан: Антуан 
минутнадеюсь: минутнадеюсь 
публично: публично 
сдаваться: сдается сдавался 
прогноз: прогнозы Прогноз прогнозов прогнозах прогноз 
прикладывать: прикладывает 
чемпионшипа: Чемпионшипа 
китай: Китае Китая Китай 
разыгрывать: разыгрывать 
брат: брата брату братьями 
нынче: нынче 
госдума: Госдумы госдумы 
пепа: Пепа 
год: годы годах года лет год годов году годам 
вести: ведет вести вел ведут 
благо: благ 
переставать: перестает 
коэффициент: коэффициентом Коэффициенты коэффициент коэффициенты коэффициентах 
спецпроект: Спецпроект 
хмурый: Хмурые 
сослагательный: сослагательного 
гранитный: гранитный 
карикатура: карикатурами 
квартира: квартиру 
сиффреддивчера: Сиффреддивчера 
ровный: ровном 
бро: бро Бро 
однажды: однажды 
коста: Кост Коста 
свойственно: свойственно 
спартак: Спартаком Спартака Спартаке СПАРТАКА спартаку Спартаку 
кёрлинг: Керлинг 
блистать: блещет 
топить: топят 
орлов: Орлов орлов 
градус: градусов градус 
ренан: Ренан 
влуте: Влуте 
район: район 
сослаться: сославшись 
хавьер: Хавьера 
грозить: грози грозит 
прогладить: прогладит 
унизить: унизил 
лопес: Лопес 
кейне: Кейне 
мечтать: мечтать мечтает Мечтаю мечтал 
болезнь: болезней Болезнь 
тренировать: тренировал тренировать 
ди: Ди 
лл: ЛЛ 
контрольный: контрольно контрольные контрольных 
возвращаться: возвращается 
сюда: сюда 
периодический: периодические 
дрова: дров 
стойкий: стойкое 
осознавать: осознают 
удалить: удалили 
восток: Восток 
животное: животные 
вытащить: вытащить вытащил вытащили 
автобус: автобуса автобус 
судимость: судимостями судимостью судимостях 
квартет: квартете 
машинный: машинного 
камешек: камешкам 
поворотный: поворотным 
отказ: отказа отказ 
ток: ток 
накинуть: накинуть 
качество: качество качестве качеств качествами 
поди: поди 
состариться: состарился 
отвернуться: отвернутся 
выявить: выявить выявила выявил выявили 
зм: ЗМ 
хватать: хватало хватает 
тонуть: тонет 
галактикос: галактикос 
шахматы: Шахматы 
бенфика: Бенфика 
рассмотрение: рассмотрение 
наверное: наверное Наверное 
движение: движению движения 
совесть: совестью совесть Совесть совести 
уменьшить: уменьшить 
формулировка: формулировку 
возможность: возможность возможностей 
хэм: Хэм 
бойкот: бойкоты 
приблизиться: приблизиться 
слышный: слышны слышна 
зтими: зтими 
вновь: вновь 
умереть: умерла УМЕРЛА 
порт: Порту порту 
круглосуточный: круглосуточную 
скучноватый: скучновато 
тухелем: тухелем 
парагваец: парагваец 
стратегический: стратегическим 
арифметика: арифметикой 
память: память памяти 
подобие: подобие 
оренбург: Оренбурга Оренбургом Оренбург 
психика: психикой 
кантон: Кантона 
всеволод: Всеволод 
шабанхаджай: Шабанхаджай 
объявлять: объявлять 
перенести: перенесено перенес перенесен 
коммуникация: коммуникациям 
провалиться: провалились провалился 
текстовый: текстовую 
спикер: спикер 
претензия: претензиями 
лос: Лос 
корея: Кореей Корея Кореи 
удинезе: Удинезе 
цинично: цинично 
сконцентрироваться: сконцентрироваться 
фарадж: Фарадж 
тяжёлый: тяжелейшего Тяжелый тяжелее тяжелые Тяжелая 
рассуждать: рассуждать 
смелость: смелости 
хек: Хек 
ценный: ценная ценен ценным 
лето: лето летом Летом 
кэп: кэп 
секретный: секретные секретное 
захватывать: захватывающей захватывающий 
алибек: Алибек 
райзен: Райзен 
ле: Ле ЛЕ 
вероятность: вероятность 
испытание: испытание 
рейндерс: Рейндерс 
нелегко: нелегко 
капитан: Капитан капитаном 
грубо: Грубо грубо 
расход: расходы 
проезд: проезда 
тун: Тун 
нормальный: нормальных нормальные нормальный 
альнасре: Альнасре 
поход: походу поход Походу 
лента: лента 
связка: связку 
немец: немцы немцами 
летие: летием летии 
салах: Салаха Салахом 
мировой: мирового мировой мировую 
спаситель: спасителя 
путинагрубо: Путинагрубо 
агирресабала: Агирресабала 
климат: климате 
бурный: бурные 
фановый: фанов 
абсолютный: абсолютные 
монце: Монце 
слоган: слоган 
томпсонсегодня: Томпсонсегодня 
инсайдер: инсайдер 
неаполитанец: неаполитанцев неаполитанцы неаполитанцам 
вторник: вторник 
рамуш: Рамуш 
бросать: бросать БРОСАЕМ бросали 
свисток: свистком свисток свистка 
подоконник: подоконнике 
палка: палке 
гордиться: горжусь 
многие: многие Многие 
окно: окно окна окном 
чехия: Чехия 
граунд: Граунд 
бенитеса: Бенитеса 
ренна: Ренна 
лч: Лч лч ЛЧ 
минимум: минимум 
стронгест: Стронгест 
тат: тату 
недостаточно: недостаточно 
променять: променял 
планета: планеты планете 
пу: Пу 
идеал: идеалов 
звездый: звездый 
подобно: подобно 
питер: Питере 
соревноваться: Соревнуются 
ангела: ангела 
райкаард: Райкаард 
подписываться: подписываться 
сон: Сон сна 
ярый: ярые 
фархан: Фархан 
гамбург: Гамбурге 
ящик: ящике 
сквозь: сквозь 
противостояние: противостояние противостояния противостоянии противостояний 
повздорить: повздорил 
непонятный: непонятный 
переизбрать: переизберут 
мудряшка: мудряшка 
против: против 
дорога: дорогу 
шапка: шапка 
моргнуть: моргнувши 
истеричка: истеричку 
жезуша: Жезуша 
настроение: настроение настроения 
гадать: гадать 
обозвать: обозвать 
повод: поводом повод повода поводу 
поделиться: Поделиться поделился 
неприятие: неприятия 
слеза: Слезы слезы 
дистанционный: дистанционное 
четверг: четверг 
пропуск: пропуска 
мак: Мак Мака 
проба: пробе 
майру: Майру 
катание: катание 
позорный: позорную 
мартусевич: Мартусевич 
кирилл: Кирилл 
зз: ЗЗ 
пропускать: пропускают пропускала пропускает пропускать 
суперталант: суперталант 
бохум: Бохум 
новиковсегодня: Новиковсегодня 
поиск: поисках поиска поиск поиски 
вокруг: вокруг 
руслан: Руслан 
ванна: ванну 
скатываться: скатываются 
дембель: Дембеле 
подробность: подробностей 
загрузить: загрузит Загрузите 
боб: Боб 
контекст: контексте 
опорный: опорный опорную 
джин: джином 
проигрыш: проигрыши Проигрыш проигрыша 
обстоятельство: обстоятельствами 
оскорбление: оскорблений оскорбление оскорблении оскорблениями 
привлечь: привлечь 
платформа: платформе 
ассистов: ассистов 
прощать: прощай 
грачеввчера: Грачеввчера 
сво: СВО 
виолентийсегодня: Виолентийсегодня 
нева: невы Неве 
наиболее: наиболее Наиболее 
неманя: Неманя 
головин: Головин Головина 
голубой: голубые Голубая голубых 
дата: дата Дата 
рон: Рон 
вышвырнуть: вышвырнуть вышвырнули 
лунев: Лунев 
ответке: ответке 
белгород: белгород 
трястись: трясись 
физика: физику физикой физике 
работоспособность: работоспособность 
чеснокупо: чеснокупо 
безнаказанный: безнаказанными 
хуан: Хуан 
харисовсегодня: Харисовсегодня 
медиалиге: Медиалиге 
преуменьшать: преуменьшать преуменьшаю 
ноу: Ноу 
поворачиваться: поворачивается 
скала: скала 
спор: спором 
прогуливать: прогуливал 
порадоваться: порадоваться 
русский: русском русский русская 
свежий: свежем 
проходимец: проходимца 
дюк: дюк 
ужасный: ужасную ужасен 
андракс: Андракс 
коммент: коммент комменты 
гонять: гонять 
кузен: кузены 
разгильдяйство: разгильдяйство 
подметить: подметил 
продлевать: продлевать 
скупить: скупить 
выкупить: выкупить выкупил 
пак: Пак 
характер: характера характер 
скамакка: Скамакка 
насторожиться: насторожиться 
проблевалась: проблевалась 
апелляция: апелляция 
единый: единое 
ахинея: ахинеи 
германия: Германия Германии 
извинение: извинения 
гарсия: Гарсию Гарсией 
предусматривать: предусматривает 
зажечь: зажжет 
связь: связи 
грилише: Грилише 
включиться: включился включиться 
понос: понос 
неплохой: неплохая неплохую неплохие 
новичок: новичков новички 
мотивировать: мотивированы мотивирует 
выступление: выступлении выступлениями выступлению 
отменить: отмененный отменили 
айн: Айну Айном 
абдерразак: Абдерразак 
непосредственный: непосредственному 
макдоналдс: Макдоналдс 
сбор: сборов сборы сбора сборах 
кузяева: Кузяева 
вакансия: Вакансия 
ход: ход ходе 
плавание: плавание 
сейду: Сейду 
испортить: испортили 
пимьенту: Пимьенту 
больно: больно 
вырвать: вырвали вырвало вырвал 
наслаждаться: наслаждаемся наслаждайтесь 
феноменальный: феноменальное феноменальная 
севилья: Севилья Севильи 
персонаж: персонаж персонажи 
разыгрываться: разыгрывался 
хрусталь: хрусталя 
сын: сын Сын сына 
итальянец: итальянец итальянцы итальянцем 
благоприятный: благоприятные 
воспоминание: воспоминания 
робинсон: Робинсон 
селекционный: селекционный 
счёт: счетом счет счету Счет счете 
жуниор: Жуниор 
физручок: физручок 
евгений: Евгения Евгений 
невольно: невольно 
сформировать: сформирована 
монца: Монца 
оспина: Оспина 
использовать: использовать использует 
очередь: очередь 
вещать: вещать 
садик: Садик 
прибегать: прибегать 
подверженный: подвержен 
святой: Святой 
частность: частности 
праздник: праздники праздникам 
стушеваться: стушевались 
димасегодня: Димасегодня 
бесперебойно: бесперебойно 
переубедить: переубедил 
песочница: песочнице 
добиваться: добивалась 
джураеввчера: Джураеввчера 
прибавлять: прибавлять 
стефан: Стефан 
тотальный: тотальном 
раздевалка: раздевалку раздевалке раздевалки 
мат: матами 
крутить: крутить 
златана: Златана 
результативный: результативные результативный результативных 
врач: врачи врачу 
хвиче: Хвиче 
адекватность: адекватность 
коммерческий: коммерческий 
нажать: Нажал нажмите 
общество: общество 
официально: официально Официально 
хранить: хранит 
жить: живут жить живу живет живешь 
попасть: попасть попало попала попал попав попадут 
фофан: Фофана 
мирча: Мирча 
кида: Кида 
макс: Макс 
артета: Артета 
стабильно: стабильно 
шеффилд: Шеффилд 
пора: пора пор 
позади: позади 
фийон: Фийон 
бенфики: Бенфики 
редактор: Редакторы 
безответный: безответных 
плеяда: плеяда 
нападать: нападающую 
позвонить: позвонил позвонили 
смущать: смущает 
оранж: Оранж 
булайхи: Булайхи 
договориться: Договорились договориться договорился договорились 
водить: водя 
долго: долго 
бандит: бандит 
джуниором: Джуниором 
знатно: знатно 
миранчука: Миранчука 
нету: нету 
флуминенсе: Флуминенсе 
королевский: Королевскому 
гарре: Гарре 
погба: погба Погба 
самуэл: Самуэл 
подать: подаст поданные подали 
триумф: триумфа 
воочию: воочию 
убийство: убийства 
дьявол: дьявола 
прошествие: прошествии 
угроза: угрозу угрозой 
зам: замом 
развернуть: развернутое 
разбирать: разбирали 
кэфы: кэфы 
лужники: Лужниках 
сосьедадом: Сосьедадом 
просто: просто Просто 
уефа: УЕФА 
попов: Попов 
петров: Петров 
мена: Мен 
ковачич: Ковачич 
усомниться: усомниться 
режим: режима 
ляпнуть: ляпнул 
манипулировать: манипулировать 
мотивационный: Мотивационная 
сжатый: сжатую 
офф: офф 
авторитетный: авторитетный 
сфотографировать: сфотографировать 
милито: Милито 
сравнение: сравнению сравнение сравнения 
выстраиваться: выстраивалась 
милоте: милоте 
президентский: президентских президентском 
брюйне: Брюйне 
законный: законное 
заскочилвчера: заскочилвчера 
кряду: кряду 
виталий: Виталий 
любительский: любительская любительского 
ценить: ценят ценим 
конфетка: конфетками 
труба: трубы 
констебль: констебль констебля констеблем 
алкоголь: алкоголем алкоголь 
происшествие: происшествия 
напрямую: напрямую 
неинтересный: неинтересно 
гурусета: Гурусета 
благосостояние: благосостоянием 
праздновать: праздновали 
орбан: Орбан 
блевать: блевать Блевать 
определиться: определиться 
архисложно: архисложно 
повторить: повторила повторив повторит 
поначалу: Поначалу 
казань: Казани 
актив: активе активом актива 
феминистка: феминистку 
мечта: мечту 
штаб: штаба штабе штаб 
удалять: удалять 
расклад: расклады 
диогу: Диогу 
кромка: кромки 
название: названием 
практически: практически Практически 
рыбак: рыбаков 
леонид: Леонида 
статусный: статусные 
оружие: оружие 
препятствие: препятствий 
пожар: пожар 
еврокубков: еврокубков 
армстронг: Армстронг 
орловсегодня: Орловсегодня 
казахстан: Казахстана 
сосредоточить: сосредоточен 
лфк: ЛФК 
влут: Влут 
транспортировка: транспортировку 
интернет: Интернет 
предстоять: предстоит 
лигта: Лигта 
рейтингование: Рейтингование 
охарактеризовать: охарактеризованная 
площадка: площадках 
трава: траве 
биатлонный: Биатлонная 
жиробассегодня: жиробассегодня 
заключаться: заключается 
аргентинец: Аргентинца аргентинцев Аргентинец 
цениться: ценятся 
иванович: Иванович 
союзный: союзная 
фиалка: фиалками фиалок 
верблюд: верблюда 
гюндоган: Гюндоган 
безэмоционально: безэмоционально 
огромный: огромное огромные огромный 
устройствосегодня: Устройствосегодня 
учиться: учиться 
замариновать: замариновать 
тоттенхэму: Тоттенхэму 
заход: захода 
отрицательный: отрицательный 
пресс: пресс 
возмутиться: возмутится 
подвесить: подвешенном 
намного: намного 
недочёт: недочеты 
суд: суде Суд судом суд суда 
щадить: щадят 
разбирательство: Разбирательства разбирательства 
конь: конь коней коне 
пожалуй: пожалуй 
впечатлить: впечатлен 
утюг: утюгом утюга 
вынести: вынес 
посещать: посещать посещает 
воткнуть: воткнул 
озвучка: озвучка 
положение: положение положении 
курбан: Курбана 
оля: Оле 
канистрасегодня: Канистрасегодня 
накосячил: накосячил 
кровь: кровь 
приплести: приплести 
алекссегодня: Алекссегодня 
скоро: Скоро скоро 
удвоить: удвоил 
примерно: примерно 
реймс: Реймс 
климоввчера: Климоввчера 
ямаля: Ямаля 
суданова: Суданова 
отделение: отделение отделением 
честно: честно 
род: роде 
ибрагимович: Ибрагимович 
отмывание: Отмывание 
конкретно: конкретно 
повторно: повторно 
размазать: размазанная 
аспект: аспект 
неправда: неправдой 
пырнуть: пырнет пырнул 
совершать: совершал 
опозицию: опозицию 
трогание: трогание 
раскошелитсьяа: раскошелитсьяа 
невероятно: невероятно 
ассиста: ассиста 
съёмка: съемку 
шмидт: Шмидт 
фейковый: фейковая Фейковая 
подобрать: подобрать 
появляться: Появляется 
отсутствие: отсутствием отсутствие отсутствия отсутствии 
маскарель: Маскарель 
трибун: трибунам 
приветствие: приветствие 
избавиться: избавились избавиться 
настояться: настоятся 
быстрый: быстрый быстрые 
побежать: побежал 
обратный: обратная 
улитинсегодня: Улитинсегодня 
суперклубов: суперклубов 
отыграть: отыграл отыграет отыграв отыграть 
йонга: Йонга 
лои: Лои 
класс: классе 
снести: снести 
пожалеть: Пожалейте 
уступить: уступив уступила уступил уступили уступит 
кэ: Кэ 
месить: меси 
окончательно: окончательно 
скрыть: скрыть 
невдомёк: невдомек 
наладиться: наладится 
редондо: Редондо 
даж: даж 
скверный: скверные 
объективно: объективно 
мамонт: мамонта 
балласт: балластом 
озвучить: озвучить 
авария: аварии аварию 
восточный: Восточной восточной 
менее: менее 
авилес: Авилес 
усиливать: усиливали 
возобновляться: возобновляются 
жёстко: жестко 
отдел: отделы 
облегчить: облегчит 
сорваться: сорвался 
утверждаться: Утверждается 
санкция: санкциями 
стандартный: стандартный 
старина: старине старина 
автоматический: автоматическом 
алькантара: Алькантара 
сервис: сервис сервисах 
ухо: уши 
ох: Ох ох 
аристархович: Аристарховича 
спорца: Спорца спорца 
развиваетсяв: развиваетсяв 
доставаться: достаются 
чушь: чушь 
аргумент: аргументы 
многолетний: многолетнему 
собака: собак собаку 
протокол: протоколе 
обида: обид 
искусство: искусство 
лоботка: Лоботка 
куба: Куба 
отдыхать: отдыхает отдыхать 
ярко: ярко 
шок: шок 
дальнейший: дальнейшего дальнейшем 
эрлинга: Эрлинга 
умение: умение умения 
атлетика: атлетика Атлетик Атлетика 
отставать: отстают отстает 
рубиться: рубиться 
лестер: Лестер Лестера 
запутаться: запутаться 
кузьминасегодня: Кузьминасегодня 
фамейе: Фамейе 
ребята: ребят 
везде: везде 
холоп: холопов 
тупой: тупым тупая 
лорьян: Лорьян 
хуниорс: Хуниорс 
прессингуют: прессингуют 
унизительный: унизительнее 
раими: Раими 
амортизация: амортизация Амортизация 
благоволить: благоволить 
выручить: вырученные выручит 
штрафной: штрафную 
специально: СПЕЦИАЛЬНО 
ад: Аде 
инцидент: инцидентом Инцидент 
ущербность: ущербность 
шрифт: шрифт 
египет: Египет Египта 
этото: этото 
глупенький: глупенькие 
газзаев: Газзаев 
калабрия: Калабрия 
поножовщина: поножовщину 
впереди: Впереди впереди 
треквартист: треквартист 
анхель: Анхель 
парковка: парковок 
воспитанник: воспитанника воспитанниками 
унижать: унижай унижать 
домой: домой 
стабильность: стабильности 
хюсай: Хюсай 
встречать: встречал 
сэмуэл: Сэмуэл 
звучать: Звучит звучало 
жалоба: жалобу 
массовый: массовые Массового 
неординарный: неординарный 
бой: боя бою 
барселона: барселоне Барселоне Барселону Барселона Барселоны 
светлана: Светлана 
лопух: лопух 
камбоджа: Камбоджа 
запороть: запорол 
ответкой: ответкой 
кержаков: Кержаков 
выдержать: выдержат 
барсой: Барсой 
указ: указом 
погодный: погодные 
история: История история историю 
кормить: кормить 
конкурент: конкурента конкуренту 
содержание: содержании содержанию содержание 
бестолковый: бестолковые 
некомфортный: некомфортен 
ивановсегодня: Ивановсегодня 
создание: Создание 
вераксосегодня: Вераксосегодня 
эмма: Эмма 
юнайтед: Юнайтед 
вывихнуть: вывихнул 
проживание: проживание 
расстроить: расстроил 
девочка: девочек девочку 
классный: классный классных 
послушать: послушаем 
поддержать: поддержала 
зайти: зашла зашел 
английский: Английский английского английский 
финансы: финансы финансами 
выборы: выборах выборами 
настрой: настрой 
кркич: кркич 
боль: боль 
хайнкеса: Хайнкеса 
определять: определяет 
канал: каналы канале канал 
правка: правку 
выполнение: выполнение выполнения 
стремиться: стремиться 
расист: расистами расистом расистов расист 
снимать: снимает 
заложник: заложники 
ннов: ннов 
сэм: Сэм 
андердога: андердога 
клоппом: Клоппом 
микроклимат: микроклимат 
пусть: Пусть пусть 
твиттер: твиттере твиттер 
добро: добре 
питерс: Питерс 
хоккейный: хоккейной 
фантастика: фантастикой 
преследовать: преследуют 
размышление: размышлений 
клопп: Клопп 
непоняааатно: непоняааатно 
смысласегодня: смысласегодня 
лаять: лаяла 
быков: быков 
вредительство: вредительством 
подопечный: подопечные Подопечные 
экспресс: Экспресс 
потушить: потушить потушили 
активистка: активистку 
важно: важно Важно 
заткнуть: заткнет 
ночь: ночь ночи 
максимально: максимально 
урок: уроками 
гребля: Гребля 
оккупировать: оккупировал 
бывало: Бывало бывало 
сантос: Сантос 
значительно: значительно 
огребать: огребал 
въехать: въехал 
форменный: форменный 
любопытно: Любопытно 
одолеть: одолеть 
кислород: кислород 
спать: спать 
николай: Николай 
шнякин: Шнякин 
побегать: побегал 
болгария: Болгария 
придержать: придержите 
желать: желаешь желать 
барсаглоров: барсаглоров 
поджечь: подожжет 
замбо: Замбо 
обход: обход 
межправительственный: межправительственные 
нидерландец: нидерландец 
спустя: спустя Спустя 
настроиться: настроиться 
глобальный: глобальная 
ватокатчика: ватокатчика 
рпл: рпл РПЛ 
галлас: Галлас 
жота: Жота 
прибыль: прибыль 
здоровый: здоровую 
чжон: Чжон 
травматичностью: травматичностью 
либо: Либо либо 
багаутдиновсегодня: Багаутдиновсегодня 
тип: тип типа типы 
прихватить: прихвати 
лавровсегодня: Лавровсегодня 
оч: оч 
гимн: гимна гимн 
сюрприз: сюрприз сюрпризом 
сходство: сходство 
невыход: невыход 
тонко: тонко 
отказать: отказали отказать 
хабаровск: Хабаровск 
касра: Касра 
ротуэлл: Ротуэлл 
пудовый: пудовыми 
штраф: штраф 
норвегия: Норвегии Норвегия 
кокаин: кокаина кокаином 
франкфурт: Франкфурт 
бренд: бренды 
кристал: Кристал 
ринкевичсегодня: Ринкевичсегодня 
израиль: Израиля 
равно: равно 
универ: Универа 
гиря: гирями 
истерик: истерик 
расставить: расставит 
прознать: прознали 
восхищаться: восхищался 
запланировать: запланировано 
кумас: Кумас 
ричард: Ричарда Ричард 
навсегда: навсегда 
пешеходточно: пешеходточно 
фергюсон: Фергюсон 
вроде: вроде Вроде 
никуда: Никуда никуда 
видосики: видосики 
байкал: Байкал 
несостоятельность: несостоятельность 
алай: Алаев 
ловить: ловят Ловит 
рб: РБ 
восемь: восемь 
перепуг: перепугу 
созидательный: созидательного 
вильярреал: Вильярреал 
рано: рано Рано 
зашкаливает: зашкаливает 
запятнать: запятнал 
скажем: скажем 
свистнуть: свистнул 
сотка: сотку 
забанили: забанили 
мужской: мужском 
великолепный: великолепные великолепен великолепное 
июль: июля июле 
член: Члены Член 
интрига: интрига интригу 
бороться: борется бороться боролись 
спец: спец 
накрыть: накрыло 
залипать: залипайте 
мера: мере 
винисиус: Винисиус 
контрабанда: контрабанду контрабандой контрабанде контрабанды 
ассист: ассист 
определение: определения 
жоанов: Жоанов 
светить: светит 
преследователь: преследователей 
негативный: негативные негативным 
задействовать: задействовать задействованы задействовал 
разговаривать: разговаривает разговаривать 
скучный: скучнейшую 
тухеля: Тухеля 
заработок: заработок 
осведомить: осведомлены осведомлен 
двоемыслие: двоемыслие 
вскоре: вскоре 
дэвид: Дэвид 
достигнуть: достигла достигнуты достиг 
четырехматчевую: четырехматчевую 
барриос: Барриос 
фартить: фартило 
они: Ими ними 
кристенсена: Кристенсена 
юрист: юрист юристу Юрист 
минск: Минске 
удочка: удочку 
переобуться: переобулся 
натуралов: натуралов 
целиком: целиком 
приход: приходе прихода приходом 
я: мной 
пренс: Пренс 
вообще: вообще Вообще 
водиться: водилась 
станислав: Станислав 
томпсончемпик: Томпсончемпик 
евпатий: Евпатий 
доступный: доступные доступна 
милон: Милонов 
мемориальный: мемориальный 
убрать: убрать 
кругосветный: кругосветными 
медиафутбол: Медиафутбол 
попп: Попп 
доходяга: доходяг 
обратить: обратил обратить 
гражданство: Гражданство гражданство гражданстве гражданства 
олег: Олег 
выпивать: выпивали 
страх: страха 
петер: Петера 
жэнщина: Жэнщина 
невозможно: невозможно 
суперкубок: суперкубок Суперкубка Суперкубке Суперкубок 
ненужный: ненужное 
молчать: молчали 
матия: Матия 
гендиректор: Гендиректор гендиректора 
валентин: Валентин 
медийный: медийную 
репортаж: репортаж 
сорок: сорока 
ужин: ужин 
период: периоде периода период 
прочность: прочности 
колашинац: Колашинац 
ен: Ен 
баня: бани 
сверху: сверху 
неизвестный: неизвестен 
вица: вице Вице 
диаш: Диаш 
собирать: собирают собирали 
напоминать: напоминать напоминает 
подкреплять: подкрепляемое 
чиновник: чиновников чиновники 
гарантировать: гарантировали 
незная: незная 
тройка: тройку тройки 
исчезнуть: исчезнут 
доллар: долларов 
вулверхэмптон: Вулверхэмптон 
бом: Бом 
речь: речь Речь речи 
именно: именно Именно 
издание: издания 
прикольный: прикольный 
пятно: пятно 
копа: Копа копа 
засушить: Засушат 
осипов: Осипов 
кабинетсегодня: кабинетсегодня 
искренне: искренне 
чжин: Чжин 
донести: донести 
раздавать: раздавать раздают раздавал 
американский: Американский американском 
носиться: носятся носились 
биться: бьются 
евро: Евро евро 
вынудить: Вынудил вынужден вынуждены 
морьентесом: Морьентесом 
квадрат: квадрате 
промышленный: промышленных 
датскийвчера: датскийвчера 
бессвязно: бессвязно 
убегать: убегает 
навскидку: навскидку 
федерация: Федерации федерации 
орать: орать 
ругательство: ругательства 
неадекватный: неадекватный 
попасться: попался 
мелочь: мелочь 
пиарить: пиарить 
вероятный: вероятным 
ковачича: Ковачича 
орган: органами органы 
фримпонг: фримпонг 
заряжать: заряжать 
оказываться: оказывается 
марат: Марата 
межличностный: межличностный 
лайкакт: лайкакт 
десятка: десяток десятку 
посидеть: Посиди 
игольный: игольное 
нечто: нечто 
адрес: адрес 
опасный: опасный 
бороца: бороца 
музыкавчера: Музыкавчера 
жар: Жар 
скучно: скучно 
провокатор: провокатором 
предпочесть: предпочту предпочел предпочтут 
заявить: заявил заявить заявила 
фернандеса: Фернандеса 
лука: Лука 
нагнетать: нагнетает 
тренироваться: тренироваться тренируешься тренируются 
плотность: Плотность 
фёдор: Федором Федор 
монцу: Монцу 
лоно: лоно 
собянин: Собянин Собянине 
рф: РФ 
ранее: Ранее ранее 
программа: программу Программу 
особый: особый особого особое 
танец: танце 
мяснойсегодня: Мяснойсегодня 
англия: Англия Англии 
фарт: фарта 
нужно: нужно Нужно 
договорняке: договорняке 
перечитать: перечитай 
ограничить: ограничил 
важничать: Важничал 
особенно: Особенно особенно 
строить: строят строить 
свищев: Свищев 
подготовка: подготовку подготовки 
грузовик: грузовик 
стрелочка: стрелочка 
вмещать: вмещает 
ик: Ик 
историюона: историюона 
африканский: африканских 
страсть: страстью 
трёхкратный: Трехкратное 
разрешать: разрешающие 
постановить: постановили 
хе: Хе 
дочь: дочь 
документалка: документалка 
денис: Денис 
кимих: Кимих 
оценивать: оценивают 
бонус: бонусами бонуса 
верный: верное Вернее 
затащить: затащить затащил 
таки: таки 
полномочие: полномочия 
опасность: опасностей 
ожидание: ожиданиями 
деклассирует: деклассирует 
поболеть: поболел 
задушить: задушить 
перебивать: перебивает 
погостнов: Погостнов 
знаток: знатока 
плевать: плевать 
встретиться: встретились встретятся встретится 
менталитет: менталитет 
рассказать: рассказал рассказала 
варелу: Варелу 
зажигать: зажигал 
глаголить: глаголить 
лист: листе 
бобслей: Бобслей 
сватать: сватали сватать 
силовик: силовиков 
войдсегодня: войдсегодня 
витинья: Витинья 
учесть: учесть 
фердинанд: Фердинанд 
джизасегодня: Джизасегодня 
относительно: относительно 
университет: университете 
новгород: Новгород 
лемар: Лемар 
сохраняться: сохранялась 
вслед: вслед 
усилие: усилий 
ставить: ставить ставил ставя ставит 
происходить: происходит 
снова: снова 
воронинсегодня: Воронинсегодня 
сезончик: сезончик 
алонсосегодня: Алонсосегодня 
народный: народная 
нагло: нагло 
освоиться: освоится 
наколотить: наколотил 
россонери: россонери 
кризис: кризис кризисе 
мечтатель: мечтатель 
эдуард: Эдуард Эдуарда 
оаэ: ОАЭА 
иньиго: Иньиго 
ильдар: Ильдар 
хилый: хило Хила 
мышь: мышей мышами 
соглашение: соглашения Соглашение 
превосходный: превосходный 
финальный: финальная финальных финальный 
лунину: Лунину 
подъезд: подъезде подъезда 
громко: громко 
почва: почву почве 
бомбить: Бомби 
человечески: человечески 
доннарумма: Доннарумма 
операция: операцию 
вампир: вампир 
старик: старика 
кадеш: Кадеш 
спад: спад 
разбрасываться: разбрасываться 
ссора: ссоры 
уругвайский: уругвайском 
приравнивать: приравниваешь 
федотов: Федотова 
медленный: медленные 
паласиос: Паласиос 
мешать: мешает мешают 
привозить: привозит привозили 
смириться: смириться 
физрук: физрука физрук 
лишний: лишне лишнего 
структура: структуру структуре 
черно: черно Черно 
френкивчера: Френкивчера 
бредли: Бредли 
вместо: вместо 
терпение: терпение 
гель: гель 
смирновсегодня: Смирновсегодня 
расширить: расширенном расширенный 
критик: критиков 
лисакович: Лисакович 
нахождение: нахождения 
арьяс: Арьяс 
арабский: арабского 
основать: основан основанную 
лейк: Лейк 
методично: методично 
эстрада: Эстрада 
мастер: Мастер мастер 
разойтись: разошлись 
довольство: довольство 
чжэн: Чжэн 
скручивать: скручивал 
жорж: Жорже 
артур: Артур 
строиться: строилась 
сомневаться: сомневаются 
блог: блог 
наверняка: наверняка Наверняка 
обладатель: обладателем 
партнёр: партнеров партнеры 
поч: Поч 
развить: развил 
ты: Тебе тебе 
украсить: украсит 
поднимать: поднимать 
лукеба: Лукеба 
беззубый: беззубую 
магия: магия магию 
оскорбить: оскорбила оскорбил 
агентский: агентскими 
шоколад: шоколада 
джа: Джа 
вряд: вряд Вряд 
нацелиться: нацелился 
самодержец: Самодержца 
перевыполнить: перевыполнил 
сбалансированный: сбалансированную 
довольно: довольно 
обстановка: обстановку обстановки 
диагностировать: диагностирован диагностировали 
фиорентина: Фиорентина 
котироваться: котируется 
шаньдун: Шаньдун 
даку: Даку 
успеть: успела успел 
датскийсегодня: датскийсегодня 
рс: РС 
ру: ру 
пятница: пятницы пятницу 
виктория: виктория 
тадич: Тадич 
эск: ЭСК 
уууу: уууу 
опуститься: опустились опустится 
клоппу: Клоппу 
вызвать: вызвал 
парагвайский: парагвайскую 
явление: явление 
посильный: посильнее 
деться: делось деться 
окова: оков 
самара: Самара 
сверхъестественный: сверхъестественное 
гу: гу 
жесть: жесть 
разогнать: разогнал 
досчитаться: досчитался 
баварец: Баварцы баварец 
встать: встанет встать 
максимальный: максимальным максимальная 
лыжа: лыжам 
крупно: крупно 
чувствительный: чувствительные 
падать: падать 
аккредитация: аккредитацию 
приобретение: приобретений 
вступаться: вступаться 
вор: Вор воре 
исключительно: исключительно 
гю: Гю 
отовсюду: отовсюду 
бунт: бунте бунт 
пользоваться: пользуется 
переписать: переписать переписанный 
фирстоввчера: Фирстоввчера 
голкипер: голкипер 
трачсегодня: Трачсегодня 
киприот: киприотов 
осложнить: осложнил 
материал: Материалы 
твой: твоего 
голливуд: Голливуд 
удивление: удивление 
юве: Юве 
дожать: дожал 
выкуп: выкупом выкуп выкупа 
камерун: Камеруна 
сэр: сэр сэра 
страшный: страшного 
адриен: Адриен 
покер: Покер 
мартовский: мартовские 
гипервезение: гипервезение 
заметить: заметить заметил заметили 
отойти: отойти 
рейнилду: Рейнилду 
премьер: премьер Премьер 
кататься: кататься 
боске: Боске 
постоянно: постоянно 
квалификация: Квалификация 
абсолютно: абсолютно 
посетитель: посетителей 
актёр: актера 
несложно: несложно 
застроить: застроили 
быдло: быдло 
иметься: имеется 
деваться: деваться 
добыть: добыт 
конченый: кончено 
голо: Голо 
примечание: ПРИМЕЧАНИЕ 
отсылать: отсылающую 
шмякин: Шмякин 
талисман: талисманом 
антоха: Антоха 
беллингема: Беллингема 
доставлять: доставляет 
французский: французской французский 
сразиться: сразиться 
невыдача: невыдача 
раскупить: раскупят 
товарняк: товарняках 
тратить: тратили тратят тратит 
оргкомитет: оргкомитета 
миланец: Миланцы миланцев 
октябрь: октября 
познакомиться: познакомимся познакомился 
корректно: корректно 
включительно: включительно 
неудержимый: неудержимая 
макрон: Макрона 
попросить: попросило попросили 
паника: панике 
без: безо 
мерка: меркам 
спастись: спаслись 
продемонстрировать: продемонстрировала продемонстрировал продемонстрируют 
просьба: просьбой 
букмекерский: Букмекерская 
карета: карета 
занятный: занятное 
переменный: переменную 
заваливать: заваливают 
безотказный: безотказный 
широта: широтах 
высказать: высказать высказал 
извинить: извините 
адаптация: адаптация 
дубай: Дубая 
пузатый: пузатая 
провальный: провальные 
достаточно: достаточно 
провокация: провокацией провокация 
менеджер: менеджера менеджеры 
клоун: клоуном Клоуны 
эстетика: эстетику 
имидж: имидже имидж 
поразительно: поразительно 
гана: Ганам 
оптимальный: оптимальную оптимальные оптимальный 
бешикташ: Бешикташ 
говно: говна говно 
обкатывать: обкатывать 
категорически: категорически 
варьировать: варьировать 
текущий: Текущая 
армия: армии 
обратиться: обратятся 
тимченкосегодня: Тимченкосегодня 
кот: кот 
тупость: Тупость 
бялтсегодня: Бялтсегодня 
пренебрежительный: пренебрежительное 
вложение: вложениях 
трубач: Трубача 
диагноз: диагноз 
тушино: Тушино 
вызволить: вызволить 
испански: испански 
среднее: среднем 
забавно: забавно 
обязывать: обязывает 
нацистский: нацистское 
переехать: переехать 
сбой: сбой 
полузащитник: полузащитника полузащитников полузащитник 
сообщество: сообщество 
востребовать: востребованы 
нереально: нереально 
дополнительно: дополнительно 
попрощаться: попрощался 
травмировать: травмировал 
чалов: Чалова 
сенсационный: сенсационным 
взаимность: взаимность 
коллекция: коллекция 
терапевтический: терапевтические 
камера: камеру 
преувеличение: преувеличения 
голый: голом 
стройка: стройку 
ариас: Ариас 
университариос: университариос 
немного: немного 
луш: Луш 
рассчитать: рассчитано рассчитан 
обозначить: обозначим 
семейный: семейной семейном 
южноамериканский: южноамериканский Южноамериканском Южноамериканский 
хорватия: Хорватии 
тумбочка: тумбочке 
довериться: доверился 
компетентный: компетентными компетентных 
ветеран: ветеранов 
догнать: догнал догнать 
коновалов: Коновалов 
дортмундский: дортмундская Дортмундский 
отборочный: отборочный 
обстоять: обстоит обстоят 
выходной: выходных 
обвинить: обвинили обвинила 
джонс: Джонс 
гагарин: Гагарина 
вперёд: вперед Вперед 
разнести: разнес 
шотландия: Шотландия 
лду: ЛДУ 
батенька: батенька 
бернард: Бернарду Бернард 
булла: Булл 
гаскойну: Гаскойну 
однако: Однако однако 
определить: определен определит определено 
бездарность: бездарность 
моратысегодня: Моратысегодня 
конопельченкосегодня: Конопельченкосегодня 
регламент: регламент регламенту 
никак: никак 
хетафе: Хетафе 
капризный: Капризный 
нижний: Нижний 
закавказье: Закавказья 
колесо: колесе колесах 
зря: зря 
влаховичем: Влаховичем 
удивительно: удивительно 
кэллендер: Кэллендер 
гостевой: гостевом 
неожиданно: неожиданно 
своевременный: своевременным 
оф: оф 
скандальный: скандальных 
целить: целя 
поздравлять: Поздравляю поздравляет 
фиорентины: Фиорентины 
замечать: замечать 
очистить: очистить 
вблизи: вблизи 
альгуасиля: Альгуасиля 
посреди: посреди 
составить: составит составило 
двоюродный: двоюродного 
круто: круто 
правление: правления 
иманоля: Иманоля 
кривцов: Кривцов 
лок: Лок 
бэйл: Бэйл 
иньяки: Иньяки 
альтернатива: альтернативу альтернативой 
ньюбленсе: Ньюбленсе 
потеря: Потеря потеря 
тренировочный: тренировочные 
секунда: секунд секунды 
япония: Японию Япония 
хайбуловсегодня: Хайбуловсегодня 
слышать: слышит 
мильонариос: мильонариос 
элбер: Элбер 
бояринцев: Бояринцев 
двукратный: двукратное двукратный 
цемент: цемента 
призвать: призвав призван 
пилиев: Пилиев 
манера: манере 
статуэтка: статуэтку 
медиафутбольный: медиафутбольный 
стесняться: стеснялись 
инакомыслящий: инакомыслящие 
мората: Мората 
признак: признаку 
безупречный: безупречны 
применительно: применительно 
преподносить: преподносят преподносила 
сча: сча 
счастливый: счастливым счастлив 
кения: Кения 
кс: КС 
лунина: Лунина 
звук: звук 
надёжный: надежна 
ничегоне: ничегоне 
болонья: Болонья Болоньи 
привносить: привносит 
прощание: прощание 
сообщить: сообщил сообщили 
дзюба: Дзюба 
мгновение: мгновение 
утомить: утомили 
выразить: выразил 
наркотраффике: наркотраффике 
долгий: долгое долгих 
маркос: Маркос 
упускать: упускают упускает 
сплошной: сплошные 
араб: арабам 
кальцоной: Кальцоной 
шавьер: Шавьер 
величие: величие 
рейнджерс: Рейнджерс 
шахтёр: Шахтер 
костыль: костылях 
омерзительный: омерзительна 
карим: Карима Карим 
фирменный: фирменный 
кайрат: Кайрат 
впрягаться: впрягается 
спланировать: спланировано 
уткин: Уткин 
циник: Циник 
вк: ВК 
учуять: учуял 
минутэтот: минутэтот 
вынесение: вынесения 
выгода: выгода 
ольмо: Ольмо 
перебор: перебор 
пепом: Пепом 
пальмас: Пальмас 
охрана: охрану 
доблестный: доблестные 
тоттенхэма: Тоттенхэма 
заседание: заседание 
стремление: стремление 
сопровождать: сопровождающем 
условный: Условный условных 
дружелюбно: дружелюбно 
лазарет: лазарете лазарета 
физически: физически 
образец: образца 
боярин: бояре 
нганну: Нганну 
футболка: футболке 
огласить: огласит 
подавить: подавлен 
формат: Формат 
извиниться: извинился извиниться 
иной: иное 
тотально: тотально 
талерантность: Талерантность 
расположиться: расположилась 
дом: дома дом доме 
пылить: пылил 
фенербахче: Фенербахче 
закрывать: закрывали 
дурак: дурак 
джуд: Джуд 
пристроить: пристроили 
потеряться: потеряться 
аль: Аль 
скупать: скупал 
сравнять: сравняли сравнял 
бист: бист 
загадочный: загадочные 
македония: Македония 
сугубо: сугубо 
рекордный: рекордный 
нидерландский: Нидерландского нидерландских нидерландский 
кублицкийвчера: Кублицкийвчера 
суета: суеты 
прадос: Прадос 
иго: игу 
золото: золото 
рассуждение: рассуждений 
игнашевич: Игнашевич 
рекопу: Рекопу 
фанах: фанах 
неизменно: неизменно 
грех: грехи 
тагиева: Тагиева 
выжигание: выжигании 
идиотский: Идиотские 
ха: ха 
планк: планка 
общественный: общественном 
холодный: холодном 
лирика: лирика 
приходиться: приходится 
преследование: преследования 
чемпионство: чемпионство 
забегать: Забегая 
закономерность: закономерностью 
мбаппе: Мбаппе 
сотрудничество: сотрудничество сотрудничестве 
гениально: Гениально 
разносторонний: разносторонний 
поверхность: поверхность 
нн: НН 
суббота: субботу 
репутация: репутацию репутация 
роза: розами 
альварес: Альварес 
соуза: Соуза 
выветриться: выветрился 
узденовсегодня: Узденовсегодня 
политически: политически 
поровну: поровну 
кубо: Кубо 
подтягивать: Подтягивать 
тяжело: тяжело 
схожий: схожи 
мохаммед: Мохаммед 
окончание: окончании 
существование: существование 
рамирес: Рамирес 
тарелка: тарелке 
банан: бананы 
пиови: Пиови 
олд: Олд 
сарухановсегодня: Сарухановсегодня 
остриё: острию 
выжимать: выжимать 
умолять: умоляя 
обойтись: обойтись обойдешься 
еврокубки: еврокубки 
грета: Грета 
оно: оно 
неизбежный: неизбежный 
единоборство: Единоборства 
бока: Боки 
понравиться: понравился 
переключиться: переключимся 
чётко: четко 
рафа: Рафой 
еврокубковые: еврокубковые 
избиение: избиение 
мендес: Мендес 
бумажка: бумажку 
телем: Телем 
прозябать: прозябать 
присмотреться: присмотреться 
блин: блин 
обесцениваться: обесценивается 
тасс: ТАСС 
зверь: зверя 
портал: портала 
эшгайю: Эшгайю 
прибавить: прибавит 
классический: Классический 
скушать: скушают 
триггер: триггером 
запретительный: запретительные 
заветный: заветную 
укреплять: укрепляют 
нап: НАП 
локомотив: Локомотив Локомотивом Локомотива 
дама: даму дамой 
арсе: Арсе 
неймарасегодня: Неймарасегодня 
взаимоотношение: взаимоотношений 
обелить: обелить 
импортный: импортные 
думбия: Думбия 
рм: РМ 
избежать: избежит избежать 
хвичи: Хвичи 
сосьедада: Сосьедада сосьедада 
мск: мск 
седьмой: седьмого седьмом 
весело: весело 
уэмбли: Уэмбли 
заурядный: заурядный 
лэй: Лэй 
заставлять: заставляет заставлял 
луиш: Луиш 
батист: Батиста 
католик: Католика 
письмо: письмо 
луческу: Луческу 
нарушать: нарушает 
вино: вина 
связанный: связанную 
аталантой: Аталантой 
гам: Гама 
фрэнк: Фрэнк 
честный: честнейший честный 
нуралиевсегодня: Нуралиевсегодня 
резерв: резерв 
учредитель: Учредителям 
разругаться: разругаться 
теньсегодня: Теньсегодня 
беспорядок: беспорядков 
смешногосегодня: Смешногосегодня 
зритель: зрителей 
неуправляемый: неуправляемый 
дипломатично: дипломатично 
прописывать: прописывать 
тандем: Тандему 
приговорить: приговорен 
потомок: потомки 
артете: Артете 
отчаянный: отчаянный 
маньяк: маньяк 
орден: орденом 
нафиг: нафиг 
приглашение: приглашения 
нормально: нормально 
процесс: процесс процессов 
гнобят: гнобят 
ростер: ростере 
сначала: сначала Сначала 
корпоратив: корпоративе 
иза: иза 
почему: Почему почему 
подтянуть: подтянуть 
татаренкосегодня: Татаренкосегодня 
йоахим: Йоахим 
махать: махать 
фейс: фейс 
бокс: Бокс 
аплодисменты: аплодисменты 
спасение: спасения 
кристально: кристально 
случайность: случайностью 
кейна: Кейна 
веа: Веа 
таковой: таковыми 
газета: газеты 
катастрофический: катастрофическое 
ой: ой 
галкинсегодня: Галкинсегодня 
йелерт: Йелерт 
целое: целом 
сметанинсегодня: Сметанинсегодня 
чал: Чалов 
бытность: бытность 
вдвоём: вдвоем 
советский: Советскому 
снабдить: снабдить 
андреа: Андреа 
документ: документы документа 
невнятно: невнятно 
улучшить: улучшили улучшил 
мэр: Мэр 
защищать: защищать защищают 
твит: твит 
наркотический: наркотических 
наркопритоны: наркопритоны 
приписка: припиской 
уточнить: уточнил 
штука: штуки 
вправе: вправе 
поймать: поймают 
барман: Барман 
мощно: мощно 
хиддинк: Хиддинк 
крышка: крышка 
макконнелл: Макконнелл 
тоттенхэмом: Тоттенхэмом 
оформление: оформлению 
толпа: толпы 
опухнуть: опух 
влаховича: Влаховича 
паула: Паулу 
игорьсегодня: Игорьсегодня 
потенциальный: потенциальных 
вступиться: вступлюсь 
познавательный: Познавательно 
сократить: сократит 
резцовсегодня: Резцовсегодня 
выехать: выехала 
литва: Литва 
василий: Василий 
декабрь: декабря 
родительский: родительскими 
моуринью: Моуринью 
кварацхелия: Кварацхелия 
делить: делят 
азиатский: азиатском Азиатской 
нытьё: нытья 
освободить: освобожден 
четвёртый: четвертое четвертом четвертого 
маг: Магу 
клиши: Клиши 
наркодилер: наркодилером наркодилер 
шаг: шаг шагов 
мерет: Мерет 
январь: январе января 
пупырку: пупырку 
покупной: покупные 
целовать: целует 
заранее: заранее 
проффутболе: проффутболе 
охота: охота 
нетрадиционный: нетрадиционных 
кадровый: кадровым 
политика: политики Политика политике 
шорты: шорт 
поворот: ПОВОРОТ 
потребоваться: потребуется 
глушаков: Глушаков 
действительность: действительность 
сидение: сидений 
фотоаппарат: фотоаппаратов 
явный: явный 
мячик: мячиком 
мальорке: Мальорке 
бест: Бест 
гудковвчера: Гудковвчера 
дарвин: Дарвина 
неоднозначно: неоднозначно 
бороздить: бороздил 
восторг: восторге 
выборг: Выборге 
правосудие: правосудие 
относительный: относительных 
катать: катают 
ослабить: ослабить 
блюдечко: блюдечке 
край: крае 
лотерея: лотерею 
принятие: принятия 
ввести: введут ввести 
домашний: домашних домашнем 
подбирать: подбирают 
фавор: фаворе 
признаться: признался 
аналитиксегодня: Аналитиксегодня 
маккенна: Маккенна 
выбраться: выбрался 
истечение: истечении 
взятка: взятку 
лютый: лютые 
балансовый: балансовая 
висеть: висит 
середнячок: середнячком 
твикнеме: Твикнеме 
мвп: МВП 
дон: Дон 
участок: участках 
актуально: актуально 
ковач: Ковач 
калашниковсегодня: Калашниковсегодня 
ветка: веткой 
зотов: Зотов 
побаиваться: побаивался 
берлин: Берлин Берлине 
сообщаться: Сообщалось сообщалось 
удачный: удачная 
лицо: лиц лицами лицом лице 
лапа: лапой 
услуга: услуги 
знак: знак 
бабский: бабскую 
гуг: Гуга 
рычаг: рычаги 
ремиро: Ремиро 
наехать: наехал 
фундамент: фундамент 
уравновесить: уравновешенные 
требле: требле 
громить: громил 
понести: понесло 
норма: норм 
рот: рта 
бггг: бггг 
чик: Чик 
левитин: Левитин 
дадыбаевсегодня: дадыбаевсегодня 
привет: Привет 
принц: принца 
ноунеймами: ноунеймами 
жургналюг: жургналюг 
выводить: выводил 
давность: давности 
команжа: Команжа 
пиняева: Пиняева 
второсортный: второсортных 
существовать: существовали существует 
опозориться: Опозорьтесь 
он: нему 
заруб: заруба 
павел: Павел 
свести: свели 
нинно: Нинно 
насчитываться: насчитывается 
сол: Сол 
чжэнъюй: Чжэнъюй 
полицмейстер: полицмейстера 
эквивалентный: эквивалентно 
двухсотый: двухсотые 
альф: Альф 
родриго: Родриго 
убить: убьют 
ян: Ян 
аа: аа 
педру: Педру 
поднадоесть: поднадоело 
земляк: земляков 
отразиться: отразятся 
вылезать: вылезай 
балованый: балованый 
полина: Полина 
значение: значение значения 
зацепить: зацепить 
дорасти: дорос 
ойан: Ойан 
кроме: Кроме кроме 
плэй: плэй 
ломать: ломать 
винисиусе: Винисиусе 
антон: Антон 
сравниться: сравнится 
вернуть: верните вернуть вернул 
низкий: низкие 
употребить: употребил употреблено 
отсюда: Отсюда 
изображение: Изображение 
вагнер: Вагнера 
аргентина: Аргентины 
уезжать: уезжали 
далее: Далее далее 
заказ: заказ 
переслать: перешли 
путь: путь 
кошмар: кошмар 
проведель: Проведель 
восстановление: Восстановление 
колоссальный: колоссальных колоссальное 
молодёжь: молодежью молодежь 
духаиль: Духаиль 
суммарно: Суммарно 
видение: видение 
прилично: прилично 
сидоров: Сидоров 
получение: получения 
тхэ: Тхэ 
повзрослеть: повзрослел 
бейл: Бейл 
лофтус: Лофтус 
тянуть: тянет 
ограждать: ограждаем 
спичка: спички 
рейс: Рейс 
добиться: добился добиться 
очки: очках очками 
алисон: Алисоном 
убеждать: убеждал 
смело: смело 
приобрести: приобрести 
зб: ЗБ 
передаваться: передается 
жёлтый: желтые Желтые 
изымать: изымала 
сейчас: щас 
плестись: плетется 
мрачный: мрачнейший 
самостоп: самостоп 
перевернуть: перевернуть 
дефицит: дефиците 
симонс: Симонс 
дно: дно дну 
признаваться: признавался 
виталя: Виталя 
чемп: чемп 
настольный: Настольный 
понимание: понимании 
наоборот: наоборот 
гулом: гулом 
непосредственно: непосредственно 
подербанят: подербанят 
слишком: Слишком слишком 
толк: толку 
меньян: Меньян 
аналог: аналогом аналог 
приз: приз 
ангуло: Ангуло 
особенность: особенность 
похвалить: похвалили 
альсугарай: Альсугарай 
газ: газом 
глупо: глупо 
разрыв: разрыв Разрыв 
мартыновсегодня: Мартыновсегодня 
послать: пошли 
филипп: Филипп 
обидеться: обиделся 
беларусь: Беларуси Беларусь 
поговорка: поговорка 
константин: Константин 
предмет: предметы 
номинально: номинально 
аллергия: Аллергия 
пеший: пеший 
случаться: случается 
бехич: Бехич 
младеновича: Младеновича 
позвать: позвал 
совместный: совместного 
втб: ВТБ 
бессмысленный: бессмысленные 
хун: Хун 
повышать: повышает 
пфф: Пфф 
значить: значить 
осень: Осенью 
обезьяна: обезьяной 
тег: Теги 
сдача: сдаче 
юласегодня: Юласегодня 
подгонять: подгоняемые 
расстановка: расстановку 
чвк: ЧВК 
освобождение: освобождение 
сильва: Сильва 
расхолодить: расхолодить 
рамка: рамках 
приглашаться: приглашаются 
отрезать: отрезал 
голосование: голосование 
датчанин: датчанами датчан 
сало: Салах 
сойти: сошли 
харвуд: Харвуд 
странновато: странновато 
лидерство: лидерство 
внебюджетный: внебюджетных 
болтать: болтать 
сгладить: сгладить 
дейк: Дейк Дейками 
роуд: Роуд 
выстоять: выстоял 
саф: САФ 
боливийский: боливийский 
веселиться: веселятся 
директор: директор 
отпуск: отпуск 
обесценить: обесценить 
уловка: уловку 
луна: луна 
включить: включили 
рок: Роке 
васильеввчера: Васильеввчера 
кино: Кином 
территория: территории 
отрабатывать: отрабатывает 
произнести: произнес произнеся 
благотворительный: благотворительным благотворительной 
значит: значит Значит 
бенфику: Бенфику БЕНФИКУ 
парусный: Парусный 
кризисный: кризисные 
можетну: можетну 
зарплатный: зарплатная 
кривотолки: Кривотолков 
широков: Широков 
хан: Хан 
лукаку: Лукаку 
нанесение: нанесение 
кызыл: Кызыл 
погибнуть: погиб 
выбыть: выбыл выбыли 
замок: замке 
прислушаться: прислушалось 
ввязываться: ввязываться 
млн: млн 
довгополыйсегодня: Довгополыйсегодня 
александер: Александер 
календарь: календаре календарь 
аляйнчик: Аляйнчик 
редко: редко 
дисциплинировать: дисциплинированы 
рекламировать: рекламировали 
пользователемпсу: пользователемпсу 
оскар: Оскар 
болт: Болта 
камыш: камыш 
продукт: продуктом 
неаполитанский: неаполитанском 
скоулз: Скоулз 
дружок: Дружок 
доиграть: доиграть 
листовка: листовок 
ямалем: Ямалем 
умо: УМО 
рубилово: рубилово 
салтыков: Салтыковым 
сломаться: сломается 
уолсолл: Уолсолл 
упрямство: упрямство 
истинный: истинное 
подход: подходе подход 
боруссия: Боруссия 
ете: ете 
эдакий: эдакий 
чудак: чудак 
чудо: чуда чудо 
тест: тестов 
задолбали: задолбали 
весовой: весовая 
пенс: пенсов 
всерьёз: всерьез 
хакка: Хакка 
эпатировать: эпатировал 
мотив: мотивам 
порвать: порвал 
хави: Хави 
волжанин: волжане 
нонейм: нонейм 
обязанность: обязанности 
белингема: Белингема 
питерский: питерские 
женщина: женщиной женщину Женщины 
пострадать: пострадала 
раед: Раед 
екатеринбург: Екатеринбург 
спортингом: Спортингом 
минувший: минувшем 
прислать: пришли 
долечиться: долечится 
гранд: гранде 
приглядеться: приглядеться 
заметно: заметно 
крестообразный: крестообразную 
поздняков: Поздняков 
багаж: багаж 
сбавить: Сбавил 
лавочникисегодня: лавочникисегодня 
умудриться: умудрился 
пепе: Пепе 
ротный: Ротен 
онлайн: онлайны 
залететь: залететь 
кликать: кличут 
любимец: любимцев 
лина: Лина 
завершать: завершает 
обустраивать: обустраивать 
поднятие: поднятия 
флаг: флагами 
психологический: Психологический 
гематологический: гематологическом 
выгшлядит: выгшлядит 
сомнение: сомнений 
кан: Кан 
просидеть: просидел 
египтянин: египтянина египтянину 
яя: Яя 
пригодиться: Пригодится 
америка: Америки Америке 
интересно: Интересно интересно 
канселу: Канселу 
отогнать: отогнал 
указание: указания 
спеть: споет 
интуитивно: интуитивно 
погребняке: Погребняке 
чудовищный: чудовищная 
киньонес: Киньонес 
четверть: четверть 
полностью: полностью Полностью 
достраивать: достраивает 
похоронить: похоронить 
искушение: искушение 
брейк: Брейк 
мюллер: Мюллера 
смелый: посмелее 
спокойно: спокойно 
сергей: Сергей 
фалафельсегодня: Фалафельсегодня 
доставить: доставить 
кюнде: Кюнде 
нисколько: нисколько 
стервятник: Стервятники 
промежуточный: промежуточное 
предположим: Предположим 
выполнять: выполняет 
впечатляетда: впечатляетда 
пирамида: пирамиде 
прага: Прага 
нарушить: нарушен 
ливер: Ливере Ливер 
черкашинвчера: Черкашинвчера 
бухать: Бухает 
благодарный: благодарен благодарный 
грозовой: Грозовая 
турецкий: турецкий 
рекомендательный: рекомендательные 
фантазёр: фантазеру 
явно: явно 
переписывать: переписывает 
организационно: организационно 
достроить: достроить 
клей: Клей 
угадать: Угадайте 
хамлет: Хамлет 
шаюнов: Шаюнов 
поберечь: поберечь 
непобедимый: непобедим 
найтись: найдутся 
крылышко: крылышки 
гений: гением 
баварский: баварского 
паредес: Паредес 
сдержать: сдержаны 
родитель: родителям 
валерий: Валерий 
расчёт: расчетом 
каир: Каир 
больница: больницы 
ибо: ибо 
сопрячь: сопряжено 
пронести: пронесло 
радостно: радостно 
налог: налоги 
выхлоп: выхлоп 
молоко: молоко 
миролюбивый: миролюбивый 
корабль: корабле корабль 
кабаковсегодня: кабаковсегодня 
стаж: стажем 
судебный: Судебное 
барепомню: барепомню 
спрашивать: спрашиваешь 
уокер: Уокер 
отдуваться: отдувался 
шторм: шторме 
всецело: всецело 
конкретика: конкретики 
жизнь: жизнь жизни 
пропорциональный: пропорциональная 
сойтись: сойдутся 
нечего: нечего 
чжэ: Чжэ 
словацкий: словацкая 
поблагодарить: поблагодарил 
суряев: Суряев 
пичкать: пичкали 
хейта: хейта 
горемычный: Горемычный 
противоречивый: противоречивого 
затянуться: затянулась 
предпосылка: предпосылок 
еврокубках: еврокубках 
серьёзно: серьезно 
харламовсегодня: Харламовсегодня 
тиав: Тиав 
стрессовый: стрессовый 
квадрупл: квадрупл 
хольм: Хольм 
открыть: открыл открыть 
руди: Руди 
мультиспортивный: мультиспортивный 
прибеднение: прибеднение 
мечтание: мечтаний 
химки: Химки 
дуда: Дуду 
партнёрский: партнерские 
легендарный: легендарной легендарного 
полгода: полгода 
поработать: поработать 
тофик: Тофика 
вклад: вклад 
досматривать: досматривал 
постараться: постарается 
морда: морда 
энтузиазм: энтузиазмом 
благоразумие: благоразумии 
маловероятный: Маловероятно 
фаланга: фалангу 
васильевкак: Васильевкак 
осуществиться: осуществится 
уменьшиться: уменьшится 
одинцово: Одинцово 
мода: моде 
борозда: борозды 
мурыжить: мурыжить 
лобановский: Лобановский 
задний: заднюю 
мальорки: Мальорки 
винисиуса: Винисиуса 
перестройка: перестройка 
основывать: основываю 
вдохновлять: вдохновлять 
эмират: Эмиратах 
насру: насру 
лишь: Лишь лишь 
трек: трек 
голанский: голанские 
перекинуться: перекинулась 
клиент: клиента 
исполком: Исполком 
подмосковье: Подмосковья 
редкость: редкость 
активировать: активировать 
чувак: чувак 
предстать: предстанет 
понедельник: понедельник 
андорра: Андорры 
баклансегодня: баклансегодня 
изначально: Изначально 
рияд: Рияд 
гимнастика: Гимнастика 
централ: централу 
газзе: Газзе 
нежели: нежели 
всадник: всадник 
избирательный: избирательных 
выездной: выездном 
грузить: грузить 
напа: напа 
диматебе: Диматебе 
носик: носиками 
обидеть: обидел 
флорида: Флорида 
жадный: жадный 
рекопа: Рекопа 
фактор: фактор фактором 
штамповать: штамповать 
полноценный: полноценным 
охеда: Охеда 
фонд: фонд 
уважаемый: уважаемый 
гвардиола: Гвардиола 
объективность: объективность 
крутило: крутил 
быстров: Быстров 
уменьшаться: уменьшаются 
переплюнуть: переплюнул 
рум: рум 
выпускник: выпускник 
бомбардирский: бомбардирские 
волков: Волков 
молча: Молча 
скандальчик: скандальчики 
экзотический: Экзотические 
открытие: открытие 
грелленортсегодня: Грелленортсегодня 
долгушин: Долгушин 
лямов: лямов 
логичный: логичным 
гариллу: гариллу 
усыновить: усыновить 
арнолд: Арнолд 
психический: психическими 
коса: коса 
мара: Мара 
беллингем: Беллингем 
возникнуть: возникнет 
неудаление: неудаление 
разглядеть: разглядела 
долгожданный: долгожданный 
абсурд: абсурд 
поступить: Поступило 
раскатать: раскатали 
нехрен: нехрен 
миранчуки: Миранчуки 
раскритиковать: раскритиковал 
арсен: Арсен 
санья: Санья 
опробовать: опробовать 
кайседо: Кайседо 
тухлый: тухлый 
увольнять: увольнять 
совершение: совершении 
еврочашка: еврочашка 
исполнение: исполнении 
поздравить: поздравил 
стероид: стероидах 
буквально: буквально 
болото: болоте 
отягчать: отягчающими 
прокурить: прокурил 
незаконный: незаконным 
васильев: Васильева 
щебуняевкакой: Щебуняевкакой 
боязнь: боязнью 
отснять: отсняли 
особо: особо 
виновник: Виновник 
путинасегодня: Путинасегодня 
доза: дозой 
отчётность: отчетности 
вполне: вполне 
сигнал: сигнала сигнал 
вещь: вещах 
негодяй: негодяй 
вне: Вне вне 
воздействие: воздействию 
волксегодня: волксегодня 
расставание: расставании 
левый: левом 
преподнести: преподнес 
восхвалять: восхвалял 
вручить: вручат 
объяснять: объясняет 
стойковича: Стойковича 
какута: какута 
высказывание: высказываниям 
заговор: заговора заговор 
ак: Ак 
атаковать: атакующая 
север: Севера 
воще: воще 
поучить: поучил 
хен: Хен 
сторонник: сторонников 
горетцка: Горетцка 
перенос: перенос 
геррейру: Геррейру 
запустить: запустить 
высморкаться: высморкался 
аннулировать: аннулированы 
минутвнезапно: минутвнезапно 
уникальный: уникальный 
давний: давние 
отстрелять: отстрелял 
екатерина: Екатерина 
мун: Мун 
кёльн: Кельн 
достойно: достойно 
кьер: Кьер 
лагер: лагере 
баланс: баланс 
наступить: наступила 
скуратов: Скуратов 
постоянку: постоянку 
сократиться: сократилось 
штат: штата 
усугубиться: усугубились 
щелчок: щелчку 
прекращаться: прекращается 
людвиг: Людвига 
ввиду: ввиду 
совпадать: совпадает 
ребрендинг: ребрендинг 
иво: Иво 
тонус: тонусе 
лавка: лавке 
восьмилетний: восьмилетними 
подозрительно: подозрительно 
репостнула: репостнула 
оспорить: оспорит 
гладбаха: Гладбаха 
обратно: обратно 
хегстад: Хегстад 
геморройщик: геморройщик 
ть: ть 
док: доков 
неокрепший: неокрепшие 
вальекано: Вальекано 
дима: Дима 
продолжаться: продолжается 
переквалифицироваться: переквалифицировался 
невеш: Невеш 
стабильный: стабильной 
начинаться: начинается 
превратиться: превратился 
испаноязычный: испаноязычном 
облачность: облачность 
интересовать: интересует 
свет: света 
расслабиться: расслабились 
велодром: Велодром 
настасича: Настасича 
маслов: Маслов 
поступь: поступь 
скаут: Скауты 
качели: качелей 
удачно: удачно 
равноправие: Равноправие 
раздербанят: раздербанят 
сохранить: сохранить 
физкультурник: физкультурник 
гаскойна: Гаскойна 
чернила: чернилами 
ильзат: Ильзат 
жаркий: жарче 
угрожать: угрожать 
неприкрытый: неприкрытые 
нужон: нужон 
выстрелить: выстрелить 
старожил: старожилов 
делаться: делаться 
прокурор: прокурор 
отгрузить: отгрузит 
леверкузен: Леверкузен 
украсть: украли 
сеанс: сеансы 
бридж: Бридж 
смотаться: смотался 
нелепый: нелепую 
вожак: вожаку 
насчитывать: насчитывает 
рекламный: Рекламный 
физподготовке: физподготовке 
болие: болие 
оцениваться: оценивается 
проявлять: проявляли 
регистрация: регистрации 
слиться: слиться 
фиорентине: Фиорентине 
торговец: торговец 
нарезать: нарезать 
союзник: союзниками 
философия: философия 
чуять: Чую 
судановвчера: Судановвчера 
борис: Борис 
дыхание: дыхании 
вызов: вызов 
взглянуть: взглянуть 
фана: фана 
эгуэс: Эгуэс 
похорошеть: похорошел 
последующий: последующим 
механизм: механизм 
повернуться: повернулась 
райан: Райан 
требовать: требует 
вначале: вначале 
подогнать: подогнать 
отчасти: отчасти 
тухелю: Тухелю 
реальныйвчера: реальныйвчера 
поляк: поляка 
отнюдь: отнюдь 
невиновный: невиновный 
ничей: ничье 
вечно: вечно 
рог: рогом 
полицейский: полицейский 
телесный: телесных 
зачахнуть: зачах 
толковый: толкового 
порошок: порошок 
ахнуть: Ахли 
середина: середине 
потребовать: потребует 
обыватель: обывателя 
чакыр: Чакыр 
норвичу: Норвичу 
кампинас: Кампинас 
нечестно: нечестно 
рассовую: рассовую 
алкаш: алкаши 
невозможность: невозможности 
поль: Поль 
опенда: Опенда 
рияде: Рияде 
недоработка: недоработка 
неверкузеном: Неверкузеном 
смутить: смутило 
москвич: москвичи 
развивать: развивал 
бынет: бынет 
памятник: памятник 
хилаля: Хилаля 
военный: военной 
подвести: подвел 
самоубийство: самоубийство 
говнище: говнище 
накрывать: накрывая 
закалиться: закалился 
жуниора: Жуниора 
мусай: Мусаев 
заигранный: заигран 
лепить: лепили 
покидать: покидает 
сегодняшний: сегодняшний 
значительный: значительное 
хеккен: Хеккен 
дым: дыма 
хакими: Хакими 
тож: тож 
приписать: приписал 
зимой: Зимой зимой 
употреблять: употреблял 
воронцовсегодня: Воронцовсегодня 
тёмный: темные 
эсса: Эсса 
пересекаться: пересекались 
умолчание: умолчанию 
кресло: кресел 
гордон: Гордон 
топорный: топорный 
верона: Верону Верона 
рядом: рядом 
магамуровсегодня: Магамуровсегодня 
разрушить: разрушит 
процедура: процедуры 
вытеснить: вытеснить 
хван: Хван 
экстрим: Экстрим 
командасегодня: Командасегодня 
внутри: внутри 
безнадёжный: безнадежнее 
познать: познать 
хендерсоне: Хендерсоне 
сычёв: Сычева 
звонок: звонков 
тестостерон: тестостерона 
предположить: предположить 
успокоиться: успокойся 
ключ: ключ 
шлегель: Шлегель 
ефремов: Ефремовым 
конёк: Коньки 
фотка: фотка 
похороны: похороны 
молоть: молоть 
продавец: Продавец 
наверно: наверно 
противостоять: противостоим 
пляжный: Пляжный 
требование: требования 
сыграться: сыграться 
еврокубковую: еврокубковую 
гави: Гави 
мерзкий: мерзкая 
внимательно: внимательно 
борец: борца 
совершенствование: совершенствования 
кунда: Кунде 
вы: вами 
переговорщик: переговорщиками 
даниэлла: Даниэлле 
оглядываться: Оглядываясь 
туринский: туринский 
мост: мосты 
вуячич: Вуячич 
многий: многими 
мма: мма 
джидда: Джидда 
значимость: значимости 
тоттенхэме: Тоттенхэме 
мелькать: мелькала 
тридцать: тридцать 
монреаль: Монреалем 
домик: домик 
гатагове: Гатагове 
дизайнер: дизайнер 
амстердамский: Амстердамский 
усматриваться: усматривалось 
позавчера: позавчера 
козни: козни 
избивать: избивает 
коллега: коллегам 
добавлять: добавляете 
яйчишки: яйчишки 
верещать: верещит 
боком: боком 
кокс: кокса 
кольцоввчера: кольцоввчера 
песня: песней 
сознание: сознание 
юридический: юридический 
ясно: ясно 
леонада: Леонада 
милинкович: Милинкович 
прош: Прош 
джеймс: Джеймса 
казанцев: казанцев 
материть: материл 
пеле: Пеле 
дюпин: Дюпин 
аяксе: Аяксе 
бессмысленно: бессмысленно 
громадный: громадное 
покерный: Покерный 
голеностоп: голеностоп 
сложить: сложивший 
краснодарский: Краснодарском 
корзина: корзине 
ушко: ушко 
имхо: ИМХО 
кулак: кулаком 
баскетболистка: баскетболистке 
былой: былые 
избить: избил 
давыдов: Давыдов 
милиционер: милиционер 
плашка: плашке 
кандидатура: кандидатур 
укладываться: укладывается 
паровоз: паровоза 
верх: верх 
выкладывать: выкладываешь 
ералысегодня: Ералысегодня 
вызывающе: вызывающе 
празднование: праздновании 
бойкотировать: бойкотировать 
эквадорец: эквадорцы 
живой: живом 
жирный: жирный 
утрировать: утрировано 
ссср: СССР 
карпов: Карпов 
пахом: пахом 
заново: заново 
